tweet_num,id_str,created_at,favorite_count,retweet_count,fav_rt_count,is_reply,tweet_text,tweet_length
0,890792730653339648,2017-07-28 04:35:11,0,0,0,True,@citizen_born AAAAAAAAAAAAAAAAHHHHHH,36
1,890792730653274112,2017-07-28 04:35:11,0,0,0,True,@LeslieBattenND AAAAAAAAAAAAAAAAHH,34
2,890792730644840449,2017-07-28 04:35:11,0,0,0,True,@AngryNIdaho AAAAAAAAAAAAAAAAAHHHHHHH,37
3,890792593658871808,2017-07-28 04:34:39,11,16,27,False,AAAAAAHHHHHHH,13
4,890791471674253312,2017-07-28 04:30:11,2,1,3,True,@bazelonbethany AAAAAAAAAAAAAAAHHHHHHHH,39
5,890790211311071233,2017-07-28 04:25:11,0,0,0,True,@parsaguin AAAAAAHHHHHHHHHHHHHHH,32
6,890790079735762945,2017-07-28 04:24:39,64,67,131,False,AAAAAAAAAAAAAAAAAAAAAAAHHHHHHHHHHHH,35
7,890788957214167040,2017-07-28 04:20:12,0,0,0,True,@YerbaDog AHHHHH,16
8,890788957126103040,2017-07-28 04:20:12,0,0,0,True,@TheDannyBarry AAAAAAAAAAAAAHHHHHHHHH,37
9,890787560825520128,2017-07-28 04:14:39,29,32,61,False,AAAAAAAAAAAAAHHHHHHHHHHHHHHHH,29
10,890785178033020928,2017-07-28 04:05:11,0,0,0,True,@NeverChaseThat AAAAAAAAAAAAAAAAAAAHHHHHHHHHHHHHHH,50
11,890785046524813312,2017-07-28 04:04:39,32,45,77,False,AAAAAAAAAAAAAAAAAAAAHHHHHHH,27
12,890783925567713281,2017-07-28 04:00:12,0,0,0,True,@mark_riedl AAAAAAAAHHHH,24
13,890782660423036928,2017-07-28 03:55:10,0,0,0,True,@sophienotemily AAAAAAAAAHHHHHHHHH,34
14,890782660297203712,2017-07-28 03:55:10,0,0,0,True,@My2citygirls AAAAAAAAAAAAAAAHHHHHHHHHHHHH,42
15,890782660297191424,2017-07-28 03:55:10,0,0,0,True,@kayladenver AAAAAAAAAAAHHHHHHH,31
16,890782660293005313,2017-07-28 03:55:10,1,0,1,True,@mcp_pol AAAAAAAAAAAAAAAAAHHHHHH,32
17,890782528302444544,2017-07-28 03:54:39,6,8,14,False,AAAHHHHHHH,10
18,890781408830136321,2017-07-28 03:50:12,7,0,7,True,@kayladenver AAAAAAAAAAAAAAAAAAHHH,34
19,890781408658157569,2017-07-28 03:50:12,0,0,0,True,@mcp_pol AAAAAAAAAHHHHHHHHHHHH,30
20,890780145384116225,2017-07-28 03:45:11,1,1,2,True,@gaia_surf AAAHHHHHH,20
21,890780145375735809,2017-07-28 03:45:11,10,0,10,True,@slooterman AAAAAHHHHHHH,24
22,890780010382053376,2017-07-28 03:44:39,91,90,181,False,AAAAAAAAAAAAAAAAAAHHHHHHHHHHHHHH,32
23,890778888820985856,2017-07-28 03:40:11,2,1,3,True,@snarkbat AAAAAAAAAAAAAAAAAAAAAAHHHHHHHHHHHHHH,46
24,890778888779042820,2017-07-28 03:40:11,0,0,0,True,@Riverwynne AAAAAAAAHHHHHHHHHHHH,32
25,890778888774746113,2017-07-28 03:40:11,2,0,2,True,@YerbaDog AAAAHHHHHHHHHHHH,26
26,890777494894280704,2017-07-28 03:34:39,30,21,51,False,AAAHHHHHHHHHHHHHHHH,19
27,890774977921896448,2017-07-28 03:24:39,46,54,100,False,AAAAAAAAAAAAAHHHHHHHH,21
28,890773855589027841,2017-07-28 03:20:11,1,0,1,True,@corimarti3 AAAAAAAAAAAAAAAAAAAHHHH,35
29,890772595695636480,2017-07-28 03:15:11,0,0,0,True,@headthbomb AAAAAAAAAHHHHHHH,28
30,890772460932657152,2017-07-28 03:14:39,29,33,62,False,AAAAAAAAAAAHHHHHHHHHHHHHH,25
31,890769946514513920,2017-07-28 03:04:39,16,12,28,False,AAAAHHHHHHHHHH,14
32,890768826304016384,2017-07-28 03:00:12,1,0,1,True,@CarleneRummery AHHHHHHHH,25
33,890767564682428416,2017-07-28 02:55:11,1,1,2,True,@Michael75252993 AAHHHHHHHH,27
34,890767564586004480,2017-07-28 02:55:11,0,0,0,True,@ra7baa AAAAAAAAAAAAAAHHHHHHHHH,31
35,890767427537121281,2017-07-28 02:54:39,25,22,47,False,AAAAAAAAAAAAAAAHHHHHHHHHH,25
36,890766304386449408,2017-07-28 02:50:11,0,0,0,True,@ra7baa AAAAAAAAAAAAAAAAAAAAAAAHHHHHHHH,39
37,890766304294121472,2017-07-28 02:50:11,0,0,0,True,@IndigoRun AHHHHHHHH,20
38,890766304256413701,2017-07-28 02:50:11,1,0,1,True,@pettazz AAAAAAAAAAAAAAAAAAAAAHHHH,34
39,890765044920791040,2017-07-28 02:45:10,7,1,8,True,@kayladenver AAAAAAAHHHHH,25
40,890765044815978496,2017-07-28 02:45:10,0,0,0,True,@ra7baa AAAAAAAAAHHHHHHHHHHHHHH,31
41,890764912930279424,2017-07-28 02:44:39,40,40,80,False,AAAAAAAAAAAAAAAHHHHHHHHHHHH,27
42,890762529135357953,2017-07-28 02:35:11,0,0,0,True,@teecres1 AAAAAAAAAAAAAHHHHHHHHHHHHHHHH,39
43,890762529101754368,2017-07-28 02:35:11,1,0,1,True,@Tess3761 AAAAAAAAAAHHHHHHHHHHHH,32
44,890762529097605121,2017-07-28 02:35:11,9,1,10,True,@Playground_66 AAAAAAAAAAAAAAAAAAAAAAH,38
45,890762397278973954,2017-07-28 02:34:39,23,18,41,False,AAAAAAAAAAAAHHHHHHHHHHHHHHH,27
46,890761275185262597,2017-07-28 02:30:12,4,0,4,True,@teecres1 AAAAAAAAAHHHHH,24
47,890761275101372416,2017-07-28 02:30:12,1,0,1,True,@MsGlea AAAAAAAAAAAAAAAHHHHHHHHHHHH,35
48,890761275084591104,2017-07-28 02:30:12,0,0,0,True,@the_other_bunny AAAAAHHHHHHHHH,31
49,890760011298861061,2017-07-28 02:25:10,0,0,0,True,@Ab_Synthia AAAAAAAAAAAAAAHHHHHHHHHHHH,38
50,890759882487603202,2017-07-28 02:24:40,62,49,111,False,AAAAAAAAAAAAAAAAAAAAHHHHHHHHHHHHHHHH,36
51,890758760251236357,2017-07-28 02:20:12,63,10,73,True,"@Playground_66 AAAAAAAAAAAAAAAAAAAAHHHHHHHHHH 
https://t.co/aofN6lUDJJ",70
52,890757493902782465,2017-07-28 02:15:10,0,0,0,True,@JohnPalkovic AAAAAAAAAAAAAAAAAHHHHHHHHH,40
53,890757362277023745,2017-07-28 02:14:39,9,7,16,False,AAAAAHH,7
54,890754845782814720,2017-07-28 02:04:39,13,11,24,False,AAAAAAAAAAHHHHHHH,17
55,890752328382504960,2017-07-28 01:54:39,34,30,64,False,AAAAAAAAAAAAAAAHHHHHHHHHHHHHH,29
56,890751206099963909,2017-07-28 01:50:11,0,0,0,True,@AmandaHilden AAAAAAAAAAAAAAAAAAAAAAHHHHHHHHHHHHHH,50
57,890749811913347072,2017-07-28 01:44:39,19,6,25,False,"AAAAAAAAAAAAAAAAAAAAAHHHHHHHHHHH 
https://t.co/RCixkFG5QR",57
58,890747295356116992,2017-07-28 01:34:39,11,5,16,False,AAAAAAAAHHHH,12
59,890744912366497793,2017-07-28 01:25:11,1,0,1,True,@a_rachel AAAAAAAAAAAAAAAAAAAAAHHH,34
60,890744778362638336,2017-07-28 01:24:39,23,7,30,False,AAAAAAAAAAAAAAAAAAAAAAHHHHHHHHH,31
61,890742263730642945,2017-07-28 01:14:39,12,4,16,False,AAAAAAAAAAAAAAAHHH,18
62,890739746695249921,2017-07-28 01:04:39,16,7,23,False,"AAAAAAAAAAAAAAAAAAAHHHHHHHHHHHHHHHH 
https://t.co/aofN6lUDJJ",60
63,890737230431612929,2017-07-28 00:54:39,18,7,25,False,AAAAHHHHHHHHHHH,15
64,890734712871952384,2017-07-28 00:44:39,27,11,38,False,AAAAAAAAAAHHHHHHHHHHHHHH,24
65,890732198801924096,2017-07-28 00:34:39,15,9,24,False,AAAAAAAAAAAAAAAAAAH,19
66,890729680176852993,2017-07-28 00:24:39,13,5,18,False,AAAAAAAAAHHHHHHHHHH,19
67,890728556636119040,2017-07-28 00:20:11,1,0,1,True,@nicolthegreat AAAAAAAAAAAAAAAAAAAAAAAHHHHHHHH,46
68,890727161971302400,2017-07-28 00:14:38,13,10,23,False,AAAAAAAAAAHHHHHHHHHHHHHHHH,26
69,890724646131249153,2017-07-28 00:04:39,14,13,27,False,AAAAAAAAAAAAAAAAHHHHHHHHHHHHHHHH,32
70,890723527086747648,2017-07-28 00:00:12,0,0,0,True,@DeanxRiley AAAAAAAHHHHHHHH,27
71,890723527078408194,2017-07-28 00:00:12,0,0,0,True,@Jgents85 AAAAAAAAAAAAAAAAAAAAAHHHHHHHH,39
72,890722260897714176,2017-07-27 23:55:10,0,0,0,True,@kimberlytp1900 AAAAAHHH,24
73,890722130236768256,2017-07-27 23:54:39,7,3,10,False,AHHHHHHHHHH,11
74,890719747297378304,2017-07-27 23:45:11,1,0,1,True,@Drk24and7 AAAAAAAAAAAAAAAHH,28
75,890719614900080640,2017-07-27 23:44:39,7,6,13,False,AAAAAAAAAAAHHHHHHHH,19
76,890717095914352641,2017-07-27 23:34:39,12,5,17,False,AAAAAAAAAAAAAAHH,16
77,890715973669486593,2017-07-27 23:30:11,0,0,0,True,@PalomboTiziana AAAAAAAAAAAHHHHHHHH,35
78,890714578774110210,2017-07-27 23:24:38,21,16,37,False,AAAAAAAAAAAAAAHHHHHHHHHHHHHHHH,30
79,890713456663572481,2017-07-27 23:20:11,1,0,1,True,@PalomboTiziana AAAAAAAAAAAAHHH,31
80,890712195574751233,2017-07-27 23:15:10,2,0,2,True,@AltBobAlmighty AAAHHHHHHH,26
81,890712065186443265,2017-07-27 23:14:39,6,7,13,False,AAAAAAAAAAAAAAAAHHHHHHHHHHHH,28
82,890709547509325828,2017-07-27 23:04:39,18,8,26,False,AAAAAAAAAAAAAAAAAHHHHHHHHH,26
83,890707163915702276,2017-07-27 22:55:11,1,0,1,True,@QuirkyGeekess AAAAAAAAAHH,26
84,890707032562700288,2017-07-27 22:54:39,17,10,27,False,AAAAAAAAAAAAAAAAAAAAAAAHHHHHHHH,31
85,890705909747503104,2017-07-27 22:50:12,1,0,1,True,"@QuirkyGeekess AAAAAAAAAAAAAAAHHHHHHHHHHHHHHH 
https://t.co/h23hgBJBeD",70
86,890704513300148228,2017-07-27 22:44:39,15,11,26,False,AAAAAAAAAAAAAAAAHHHH,20
87,890701997204267009,2017-07-27 22:34:39,22,25,47,False,AAAAAAAAAAAAAHHHHHHHHHHHH,25
88,890699482270138369,2017-07-27 22:24:39,9,4,13,False,AAHHHHHH,8
89,890696964253339648,2017-07-27 22:14:39,13,9,22,False,AAAAAAAAAAAAAAAAAAAHHHHHHHHHHH,30
90,890695842373545984,2017-07-27 22:10:11,0,0,0,True,@gotravelgear AAAAAAAAAAAAAAHHHHHHHHHH,38
91,890695842130276352,2017-07-27 22:10:11,0,0,0,True,@FloorvandeP AAAAAAAAAAAAAAAAAAAAAAH,36
92,890694447700336641,2017-07-27 22:04:39,14,9,23,False,AAAAAAAHHHHHHHH,15
93,890693328827822080,2017-07-27 22:00:12,1,0,1,True,@phemory AAAAAAAAAAAAHHHHHHHHHH,31
94,890691934494355456,2017-07-27 21:54:40,30,22,52,False,AAAAAAAAAAAAAAAAAHHHHHHHH,25
95,890690814808133632,2017-07-27 21:50:13,1,0,1,True,@melmaxson AAAAHHHHHHHHHHH,26
96,890690814493560832,2017-07-27 21:50:13,1,0,1,True,@DrMRFrancis AAAAAAAAAAHHHHHHHHHHHH,35
97,890689417026949120,2017-07-27 21:44:39,6,6,12,False,AAAAAAAAAAAH,12
98,890686897277763584,2017-07-27 21:34:39,8,12,20,False,AAAAAAAAAAAAAAAHHHHH,20
99,890685775616069634,2017-07-27 21:30:11,0,0,0,True,@1_april_fool AAAAAAAAAAAAAAAAAAAAAAHHHHHHHHHHHHH,49
100,890684518578913280,2017-07-27 21:25:12,1,1,2,True,@1_april_fool AAAAAAAAAAAAAAAAAAAAAHHH,38
101,890684380208910337,2017-07-27 21:24:39,16,9,25,False,AAAAAAAAAAHHHHHHHHHHHHH,23
102,890683257846722561,2017-07-27 21:20:11,2,0,2,True,@AhmedBaba_ AAAAAAHHHHHHHHHHHHHHHH,34
103,890681864284983297,2017-07-27 21:14:39,8,7,15,False,AAAAAAAAAAAAAAAAAAHHHHHHHHHH,28
104,890680744334458881,2017-07-27 21:10:12,0,0,0,True,@inchoaterica AAAAAAAAAAAHHHHHHHHHHHHHHHH,41
105,890679350923755520,2017-07-27 21:04:39,8,8,16,False,AAAAAAAAAAAAAAAAAAAAAHH,23
106,890676833351417856,2017-07-27 20:54:39,10,2,12,False,"AAAAAAAAAAAAAAAAAAAAAAAHHHHHHHHHHHHHHH 
https://t.co/GjpsuOixUq",63
107,890674317792497665,2017-07-27 20:44:39,8,5,13,False,AAAAAAAAAAAAAAAAAAHHHHHHHHHHHH,30
108,890671798479593472,2017-07-27 20:34:39,14,7,21,False,AAAAAAAAAAAAAAAHHHHHHHH,23
109,890669282715197441,2017-07-27 20:24:39,2,4,6,False,AHHHHHH,7
110,890666766816354306,2017-07-27 20:14:39,3,2,5,False,AAAAAAAHHHHHH,13
111,890664249009119232,2017-07-27 20:04:39,3,0,3,False,AAAAAAAAAAAAH,13
112,890661730900217856,2017-07-27 19:54:38,7,2,9,False,AAHHHHHHHHHHHHH,15
113,890659217429766144,2017-07-27 19:44:39,16,7,23,False,AAAAAAAAAAAAAAAAAAAAAAAHHH,26
114,890656699434053632,2017-07-27 19:34:39,10,4,14,False,AAAAAAAAAAAAAAAAHHHHHHHHHHHHHHH,31
115,890654183988359168,2017-07-27 19:24:39,7,3,10,False,AAAAAHHHHH,10
116,890651667841957889,2017-07-27 19:14:39,7,2,9,False,AHHHHHHHH,9
117,890650550164799489,2017-07-27 19:10:13,1,0,1,True,@IdesofMarch1961 AAAAAAHHHHHHH,30
118,890649283178799104,2017-07-27 19:05:11,0,0,0,True,@1openbrain AAAAAAAAAAAAAHHHHHHHHHHHH,37
119,890649150324260864,2017-07-27 19:04:39,15,7,22,False,AAAAAAHHHHHHH,13
120,890648033548881920,2017-07-27 19:00:13,0,0,0,True,@KatherineK221 AAAAAAAAAAAAAAAHHHHHHHHHHHH,42
121,890646634119389184,2017-07-27 18:54:39,6,6,12,False,AAAAAAAAAAAAAAAHHHHHHHHHHHHH,28
122,890644118090596352,2017-07-27 18:44:39,20,10,30,False,AAAAAAAAAAAAAAAAAHHHHHHHHHHHHHH,31
123,890641602170953729,2017-07-27 18:34:39,7,6,13,False,AAAAAAAAAAAAHHHHHHH,19
124,890639084036608000,2017-07-27 18:24:39,8,2,10,False,AAAAAAHHHH,10
125,890637963486306304,2017-07-27 18:20:12,0,0,0,True,"@MoLovelly AAAAAAAAAAAAAAAAAHHHHH 
https://t.co/yV4VitNGzn",58
126,890636568414883841,2017-07-27 18:14:39,14,4,18,False,AAAAAAAAAAAAAAAAAAAAAAAHHH,26
127,890634049865306114,2017-07-27 18:04:39,12,6,18,False,AAAAAAAHHHHHHHHHHH,18
128,890631534503370752,2017-07-27 17:54:39,12,7,19,False,AAAAAAAAAHHHHHHHHHH,19
129,890629152948277249,2017-07-27 17:45:11,1,1,2,True,@marisathemighty AAAAAAAAAAAAAAAHHHHHH,38
130,890629015962349569,2017-07-27 17:44:39,9,2,11,False,AAAAAAAAAAAAAAAHH,17
131,890627897806868480,2017-07-27 17:40:12,1,0,1,True,@brlindsay88 AAAAAAAAHHHHHHH,28
132,890626501221265408,2017-07-27 17:34:39,12,2,14,False,AAAAAAAHH,9
133,890625381249699840,2017-07-27 17:30:12,1,0,1,True,@HermitOnTheLake AAAAAAAAAAH,28
134,890625381136343041,2017-07-27 17:30:12,0,0,0,True,@lovablemarketer AAAAAAAAAAAAAAAAAAAHHHHHHH,43
135,890623984001089536,2017-07-27 17:24:39,16,11,27,False,AAAAAAAAAAAAAAAAHHHHHHHH,24
136,890621469184581632,2017-07-27 17:14:39,5,7,12,False,AAAAAAAAAAAAAAAAHHHHHHHHHHHHHHHH,32
137,890618953088737280,2017-07-27 17:04:39,4,3,7,False,AAAAAHHHHHHHHHH,15
138,890616433796726785,2017-07-27 16:54:39,10,5,15,False,AAAAAAAAAAAAHHHH,16
139,890614050379317248,2017-07-27 16:45:11,1,0,1,True,@parsaguin AHHHH,16
140,890613918074150912,2017-07-27 16:44:39,8,5,13,False,AAAAHHHHHHHHHHH,15
141,890611535646670848,2017-07-27 16:35:11,0,0,0,True,@GraciousKY AAHHHHHHHH,22
142,890611402674667520,2017-07-27 16:34:39,12,7,19,False,AAAAAAHHHHHHHHHHHHHHH,21
143,890608885492588544,2017-07-27 16:24:39,4,1,5,False,AAHHHHHHHHHHHHHHHH,18
144,890606502477570048,2017-07-27 16:15:11,0,0,0,True,@durindal AAAHHHHHHHHHHHHHH,27
145,890606502469226496,2017-07-27 16:15:11,0,0,0,True,@megbrod12 AAAAAAAAAAAAAAAAAAAAAAHHHH,37
146,890606367441997824,2017-07-27 16:14:39,8,5,13,False,AAAAAAAAAAAAAHHHHHHHHH,22
147,890603851706847232,2017-07-27 16:04:39,7,3,10,False,AHHHHHHHHHHHH,13
148,890601336416415744,2017-07-27 15:54:39,9,4,13,False,AAAAAAHHHHHHHHHHHH,18
149,890598819334942722,2017-07-27 15:44:39,8,5,13,False,AAAAAAAAAHH,11
150,890596301141880834,2017-07-27 15:34:39,18,14,32,False,AAAAAAAAAAAAAAAAAAAHHHHHHHHHHHH,31
151,890593917418315776,2017-07-27 15:25:11,0,0,0,True,@BlueSpaceCanary AAAHHHHHHHHHHHHHHHH,36
152,890593785318711301,2017-07-27 15:24:39,9,3,12,False,AAAAAAAAAAAAAAAAAAAAHHH,23
153,890591405780987904,2017-07-27 15:15:12,0,0,0,True,@emtamsyn AAAAAAAAAAAHHHHHHHHHHH,32
154,890591269256343552,2017-07-27 15:14:39,5,1,6,False,AAAAHH,6
155,890590149242966016,2017-07-27 15:10:12,0,0,0,True,@biobabbler AAAAAAAAAAAAAAAAAAAAAAHHHHHHHHHHHHHH,48
156,890588754217496577,2017-07-27 15:04:40,23,10,33,False,AAAAAAAAAAAAAAAAAAAAHHHHHHHHHHH,31
157,890586235407912960,2017-07-27 14:54:39,4,2,6,False,AAAAHHHHHHH,11
158,890583719748284417,2017-07-27 14:44:39,7,1,8,False,AAAAAAAAAAAHH,13
159,890581201886511104,2017-07-27 14:34:39,10,3,13,False,AAAAAAAAHHHHHHHHHHHHH,21
160,890580081248227328,2017-07-27 14:30:12,1,0,1,True,@boredbostonian AAAAAAAHHHHH,28
161,890578684708626433,2017-07-27 14:24:39,7,4,11,False,AAAAAAHHHHHHHHHHHHH,19
162,890576167597748225,2017-07-27 14:14:39,7,2,9,False,AAAAAAAAAAHHHHHHHHHH,20
163,890573651023671296,2017-07-27 14:04:39,6,4,10,False,AAAAAAAAAAAAAAHHHHHHHHHHHHHH,28
164,890571135557021696,2017-07-27 13:54:39,7,5,12,False,AAAAAAAAAAAAAAAAAAAAAAAHHHHHHHHHH,33
165,890568617888231426,2017-07-27 13:44:39,5,4,9,False,AAAAAAAAAAH,11
166,890566101486194689,2017-07-27 13:34:39,9,4,13,False,AAAHHHHHHHHHHH,14
167,890563584220168193,2017-07-27 13:24:39,10,7,17,False,AAAAAAAAAAAAAAAAAAAAAHHHHHHH,28
168,890561070275973121,2017-07-27 13:14:39,9,0,9,False,AAAAAHHHHHHH,12
169,890559949289422848,2017-07-27 13:10:12,1,0,1,True,@the_doc28 AAAAAHHHHHH,22
170,890558551718072320,2017-07-27 13:04:39,16,6,22,False,AAAAAAAAAAAAAAAAAAAAAAHHHH,26
171,890556041108312064,2017-07-27 12:54:40,3,2,5,False,AHHHHHHHHHHHHHHHH,17
172,890553520541356032,2017-07-27 12:44:39,10,3,13,False,AAAAAAAHHHH,11
173,890551141485957120,2017-07-27 12:35:12,2,1,3,True,@Homiciide AAAAAAAAAAAAAAAAAAAHHHH,34
174,890551003724095491,2017-07-27 12:34:39,18,7,25,False,AAAAAAAAAAAAAAAAAAAHHH,22
175,890549883429687296,2017-07-27 12:30:12,2,0,2,True,@LadyHawkins AAAAAAAAAAAAAAAAAAAAAHHHHHHHHHHH,45
176,890548619992084480,2017-07-27 12:25:11,1,0,1,True,@chrissiebmoore AAAAAAHHHHHHHHHHHHHHH,37
177,890548619979476994,2017-07-27 12:25:11,1,0,1,True,@EricaRoman_ AAAAAAAAAAAAAAAAHHHHHH,35
178,890548486378323969,2017-07-27 12:24:39,15,10,25,False,AAAAAAAAAAAAAAAAAAAHHHHHHHHH,28
179,890547364330688512,2017-07-27 12:20:11,0,0,0,True,@defectiveMom AAAAAAHHHHHHHHH,29
180,890545971385511938,2017-07-27 12:14:39,6,4,10,False,AHHHHHHH,8
181,890543454849249281,2017-07-27 12:04:39,6,0,6,False,AAHHHH,6
182,890542337742581761,2017-07-27 12:00:13,0,0,0,True,@Cassand78422817 AAAHHHHHHHH,28
183,890540937893601280,2017-07-27 11:54:39,17,5,22,False,AAAAAAAAAAAAAAAHHHHHHH,22
184,890538554958508036,2017-07-27 11:45:11,0,0,0,True,@gus_posey AAAAAAAAAAAAAAAAAAAAAAAHHHHHHHHH,43
185,890538420539404289,2017-07-27 11:44:39,14,5,19,False,AAAAAAAAAAAAAAAAAAHHHHHHHHHHHHH,31
186,890536039655321602,2017-07-27 11:35:11,0,0,0,True,@Cassand78422817 AAAAAAAAAAAAAAAAAHHHHHHHHHHHHH,47
187,890535904502263811,2017-07-27 11:34:39,11,2,13,False,AAAAAHH,7
188,890533387508776961,2017-07-27 11:24:39,5,1,6,False,AHHH,4
189,890531003835572224,2017-07-27 11:15:11,0,0,0,True,@MrGrahamClegg AAAAAAAAHHHHHHHHHHHHHHHH,39
190,890530872079855616,2017-07-27 11:14:39,12,6,18,False,AAAHHHHHHHHHHHH,15
191,890529751445774336,2017-07-27 11:10:12,0,0,0,True,@TakeThatSalk AAAAAAAAAAAAAAAAAHHHHHHHHHHHH,43
192,890529751445757952,2017-07-27 11:10:12,0,0,0,True,@6x10E23 AAAAAAAAAAAAHH,23
193,890528486326231040,2017-07-27 11:05:11,1,0,1,True,@inksharknet AAAAAAAHHHHHH,26
194,890528354843201536,2017-07-27 11:04:39,8,1,9,False,AAAAAAAAAAAAAAHHHHHHHHHHH,25
195,890525836222373892,2017-07-27 10:54:39,8,8,16,False,AAAAAAAAAAAAAAAHHHHHHHH,23
196,890523452620378114,2017-07-27 10:45:10,0,0,0,True,@hall_mackey AAAAAAAHHHHHHHHHHHHHH,34
197,890523319962914816,2017-07-27 10:44:39,6,2,8,False,AAAAAAAAHHHHHHHHHHHH,20
198,890522200083755009,2017-07-27 10:40:12,0,0,0,True,@lovablemarketer AAAAAAAAAAAHHHHHHHHHHHHH,41
199,890520937354993664,2017-07-27 10:35:11,3,0,3,True,@6x10E23 AAAAAAAAAHHH,21
200,890520803162423296,2017-07-27 10:34:39,13,6,19,False,AAAAAAAAAAAAAAAAAAAHH,21
201,890518286944923649,2017-07-27 10:24:39,2,0,2,False,AHHHH,5
202,890515771625013248,2017-07-27 10:14:39,4,1,5,False,AAAAAAAAHHHHHHHH,16
203,890513389218353153,2017-07-27 10:05:11,0,0,0,True,@grimalkintalk AAAAAAAAAAAAAAAAAAAAHHHHHHHHHHHHHHHH,51
204,890513254488952832,2017-07-27 10:04:39,4,7,11,False,AAAAAAAAAAAAAAAAAAAAAAHHHHHHHHHHHH,34
205,890510737705185280,2017-07-27 09:54:39,4,3,7,False,AAAAAAHHHHHHHHH,15
206,890508220774666240,2017-07-27 09:44:39,6,4,10,False,AAAAAAAAAAAAHHHHHHHHHH,22
207,890507099943337984,2017-07-27 09:40:12,0,0,0,True,@butterfly363636 AAAH,21
208,890505703235956737,2017-07-27 09:34:39,1,1,2,False,AAAAAHHHHHHHH,13
209,890503188503310337,2017-07-27 09:24:39,4,2,6,False,AHHHHHHHHHH,11
210,890500671274962944,2017-07-27 09:14:39,3,1,4,False,AAAAAAAAAAAAAAHHH,17
211,890498153174249472,2017-07-27 09:04:39,8,4,12,False,AAAAAAAAAAAAHHHHHHHHHHHHHHH,27
212,890495640077250561,2017-07-27 08:54:39,1,1,2,False,AAHHHHHHHH,10
213,890493123331338240,2017-07-27 08:44:39,2,0,2,False,AAAAAAAAAAAAAHHHHHHH,20
214,890490606295953408,2017-07-27 08:34:39,7,2,9,False,AAAAAAAAAAAAAAHHHHHHHHHH,24
215,890488089575137280,2017-07-27 08:24:39,4,3,7,False,AAAAAAAAAAAAAAAHHHHH,20
216,890485570648104960,2017-07-27 08:14:39,5,4,9,False,AAAAAAAAHHHHHHHHHHHHHH,22
217,890483055957245953,2017-07-27 08:04:39,6,6,12,False,AAAAAAAAAAAAAAAAAAAAHHHHHHHHHHHH,32
218,890480537776914432,2017-07-27 07:54:39,2,2,4,False,AAAAH,5
219,890478023560089606,2017-07-27 07:44:39,4,1,5,False,AAAAAAAAAAAAHHH,15
220,890475504154796032,2017-07-27 07:34:39,11,6,17,False,AAAAAAAAAAAAAAHHHHH,19
221,890473124730462209,2017-07-27 07:25:11,0,0,0,True,@adelgallegoh AAAAAAAAAAAAAAAAHHHHHHHHHHHH,42
222,890472990722465792,2017-07-27 07:24:39,10,0,10,False,"AAAAAAAAAAAAAAAAAAAAAHHHHHHHHHH 
https://t.co/RCixkFG5QR",56
223,890470471409565696,2017-07-27 07:14:39,11,8,19,False,AAAAAAAAAAAAAAAH,16
224,890468089883750404,2017-07-27 07:05:11,1,0,1,True,@JuannyCash AAAAAAHHHHHHH,25
225,890467955879936004,2017-07-27 07:04:39,8,5,13,False,AAHH,4
226,890465439956041729,2017-07-27 06:54:39,20,11,31,False,AAAAAAAAAAAAAAAAAAAHHHHHHHH,27
227,890462921939189760,2017-07-27 06:44:39,19,10,29,False,AAAAAAAAAAAAAAAAAHHHH,21
228,890460538324602881,2017-07-27 06:35:10,0,0,0,True,@my_2commoncents AHHHHHHH,25
229,890460406183014400,2017-07-27 06:34:39,6,3,9,False,AAHHHHHHHHHHH,13
230,890458024602726401,2017-07-27 06:25:11,0,0,0,True,@my_2commoncents AAAAAAAAAAAAH,30
231,890457892414947328,2017-07-27 06:24:40,6,1,7,False,AHHHHHHHHHHH,12
232,890455373148291072,2017-07-27 06:14:39,11,1,12,False,AAAAAAAAAAAHHHHHHHHHH,21
233,890452854942683136,2017-07-27 06:04:39,14,7,21,False,AAAAAAAAAAAAHHHHHHHHHHH,23
234,890450474192842752,2017-07-27 05:55:11,1,0,1,True,@kblood AAAAAAAH,16
235,890450337877942272,2017-07-27 05:54:38,10,2,12,False,AAAAAAAAAAAAAAAAAAAAAHHHHHHHHHHHHH,34
236,890447821694017536,2017-07-27 05:44:39,11,5,16,False,AAAAAAAAAAAAAHHHHHHHHHHHH,25
237,890445305728167936,2017-07-27 05:34:39,7,1,8,False,AAAAAAAAAAAAAHHH,16
238,890442790936731648,2017-07-27 05:24:39,11,3,14,False,AAAAAAAAAAAAAAAAAAHHHHHH,24
239,890440275067318272,2017-07-27 05:14:39,19,5,24,False,AAAAAAAAAAAAAAAAAAAAHHHHHHHHHH,30
240,890437759088963584,2017-07-27 05:04:39,24,5,29,False,AAAAAAAAAAAAHHHHHHHHHHHHHH,26
241,890435238555418624,2017-07-27 04:54:39,82,42,124,False,AAAAAAAAHHHHHHHHHH,18
242,890432725039153152,2017-07-27 04:44:39,12,2,14,False,AAAAAAAAAAAAAHHHH,17
243,890431604996415489,2017-07-27 04:40:12,0,0,0,True,@SMO404 AHHHH,13
244,890430207789850624,2017-07-27 04:34:39,10,2,12,False,AAAAAAAAAAAAAAAAHHHHH,21
245,890427692671262720,2017-07-27 04:24:39,13,6,19,False,AAAHHHHHHHHH,12
246,890425172444012544,2017-07-27 04:14:39,11,4,15,False,AAAAAAAAAAAAHHHH,16
247,890422660009734144,2017-07-27 04:04:40,13,7,20,False,AAAAAAAAAHHHHHHHHHHH,20
248,890420141116317697,2017-07-27 03:54:39,22,13,35,False,AAAAAAAAAAAAAAAAHHHHHHHHHHHHHH,30
249,890417622495440896,2017-07-27 03:44:39,10,7,17,False,AAAAAAAAAAAAAHH,15
250,890415109071400960,2017-07-27 03:34:39,12,6,18,False,AAAAAAAAAAAAAHHHHHH,19
251,890412590265978880,2017-07-27 03:24:39,6,2,8,False,AAAAAHHHH,9
252,890410072765063168,2017-07-27 03:14:39,24,4,28,False,AAAAAAAAAAAAAAAAAAAHHHHHH,25
253,890407556866244608,2017-07-27 03:04:39,20,16,36,False,AAAAAAAAAAAAAAAAAAAAAAHHHHHH,28
254,890405039570923521,2017-07-27 02:54:39,23,11,34,False,AAAAAAAAAAHHHHHHHHHHHHHHH,25
255,890402656853929984,2017-07-27 02:45:10,0,0,0,True,@lurker1781 AAAHHHHHHHHHHHHHHHH,31
256,890402656841342976,2017-07-27 02:45:10,0,0,0,True,@Dzigavertovv AAAAAAAAAAAAAAAAAAAAAAAHHHHH,42
257,890402525710614532,2017-07-27 02:44:39,17,14,31,False,AAAAAAAAAAAAAAAAAAAAAHH,23
258,890400007777660929,2017-07-27 02:34:39,8,3,11,False,AAAHHHHHH,9
259,890397490637398016,2017-07-27 02:24:39,12,7,19,False,AAAAAAAHHH,10
260,890394974931619840,2017-07-27 02:14:39,22,10,32,False,AAAAAAAAAAAAAAAAAAAAHHHHHHHHHHHHHHH,35
261,890392460492492800,2017-07-27 02:04:39,19,9,28,False,AAAAAAAAAAAAAAAAAAAAAHHHHHHHH,29
262,890389940827246594,2017-07-27 01:54:39,14,3,17,False,AAAAAAAAAAAAAAHHHHHHHHHHHHHHHH,30
263,890387424592973825,2017-07-27 01:44:39,19,5,24,False,AAAAAAAAAAAHHHHHHHHHHHH,23
264,890384909919027200,2017-07-27 01:34:39,11,7,18,False,AAAAAAAAAAAH,12
265,890382523213262848,2017-07-27 01:25:10,0,0,0,True,@jessedlanded AAAAAAAHHHHHHHHH,30
266,890382393235959817,2017-07-27 01:24:39,13,5,18,False,AAAAAAAAAAHHHHHHHHHHHH,22
267,890379876598939648,2017-07-27 01:14:39,15,5,20,False,AAAAAAAAAHHH,12
268,890378754874363906,2017-07-27 01:10:12,0,0,0,True,@claireannrice AAAH,19
269,890377493835894784,2017-07-27 01:05:11,1,0,1,True,@claireannrice AAAAHHHH,23
270,890377360767430656,2017-07-27 01:04:39,14,5,19,False,AHHHHHHHHHHHHHHH,16
271,890376242943455232,2017-07-27 01:00:13,0,0,0,True,@wubaloh AAAAAAHHHHHHHH,23
272,890374840745676800,2017-07-27 00:54:39,17,14,31,False,AAAAAAAAAAAAAAAAAAAAHHHHHHH,27
273,890372325891330048,2017-07-27 00:44:39,19,9,28,False,AAAAAAAAAAAAAAAAAAAAAHHHH,25
274,890371203558408193,2017-07-27 00:40:11,0,0,0,True,@lyssophobic AAAAAAAAAAAAAAAAAAHHHH,35
275,890369810772742144,2017-07-27 00:34:39,13,2,15,False,AAAAHHHHHHHHH,13
276,890367427716034560,2017-07-27 00:25:11,0,0,0,True,@11000volts AAHHHHHHHHHHH,25
277,890367294387490816,2017-07-27 00:24:39,8,2,10,False,AAAHH,5
278,890364906737979393,2017-07-27 00:15:10,1,1,2,True,@OvernightHaulin AAAAAAAAAAAAAAAAAAAAAAHHHHHHHHH,48
279,890364775661801473,2017-07-27 00:14:39,12,2,14,False,AAAAAAAHHHHHHHHHH,17
280,890362262086660096,2017-07-27 00:04:40,18,10,28,False,AAAAAAAAAAAAAAAAAHHHHHHHHHH,27
281,890359741800644608,2017-07-26 23:54:39,15,2,17,False,AAAAAAAAAHHHHHHHHHHHHHH,23
282,890357225373487107,2017-07-26 23:44:39,14,4,18,False,AAAAAAAAAAAAAAAAAAH,19
283,890354711144148997,2017-07-26 23:34:39,9,3,12,False,AAAAAAAAAAHHHHHHHHHHHHHH,24
284,890352326887735296,2017-07-26 23:25:11,1,0,1,True,@keepyalifeyours AAAAAAAAAHHHHHHHHHHHHHHHH,42
285,890352192749752320,2017-07-26 23:24:39,32,19,51,False,AAAAAAAAAAAAAAAAAAAAHHHHHHHHHHHHH,33
286,890349675294986240,2017-07-26 23:14:39,13,1,14,False,AAAAAAAAAAHHHHHHHHHHHHHHHH,26
287,890347162457997312,2017-07-26 23:04:40,17,7,24,False,AAAAAAAAAHHHHHHHHHHHHHHH,24
288,890346057011347456,2017-07-26 23:00:16,0,0,0,True,@Draconis1999 AAAAAAAAAAAAAAAH,30
289,890344775718764544,2017-07-26 22:55:10,1,0,1,True,@tyflec AAAAAAAHHHHHHHH,23
290,890344775672635392,2017-07-26 22:55:10,1,0,1,True,@Draconis1999 AAAAAAAAAAAAAAAAAAAAAAHHHHHHHHHHHHHHH,51
291,890344640536293376,2017-07-26 22:54:38,16,4,20,False,AAAAAAAAAAAAAAAAAAHHHHHHHH,26
292,890343517553397761,2017-07-26 22:50:11,0,0,0,True,@paraempathetic AAAAAAAAHHHHHHHH,32
293,890342128521555969,2017-07-26 22:44:39,16,3,19,False,AAAAAAAAHH,10
294,890339609170849792,2017-07-26 22:34:39,11,6,17,False,AAAAAAAH,8
295,890337092621959172,2017-07-26 22:24:39,7,2,9,False,AAAAHHHHH,9
296,890335973585936388,2017-07-26 22:20:12,0,0,0,True,@sirala6 AAAAAAAAAAAAAAAAAAAAAAAHHHHHHHHHHH,43
297,890334576190607360,2017-07-26 22:14:39,11,2,13,False,AAHHHH,6
298,890332061755691009,2017-07-26 22:04:39,14,6,20,False,AAAAAAAAAAAAHHHHHHHHH,21
299,890330943977902080,2017-07-26 22:00:13,0,0,0,True,@jacobjerickson AAAAAAAAAAAHHHHHHHH,35
300,890329545424998401,2017-07-26 21:54:39,8,2,10,False,AAAAAHHHHHHHHHHHHHHH,20
301,890327028624437254,2017-07-26 21:44:39,8,2,10,False,AAHH,4
302,890324512604135426,2017-07-26 21:34:39,13,7,20,False,AAAAAAAAAAAAAAAAAAAAHHHH,24
303,890321994180440066,2017-07-26 21:24:39,9,3,12,False,AAAAAAAAAAAAAAHHHHHH,20
304,890319475291164672,2017-07-26 21:14:38,12,5,17,False,AAAAAAAAHHH,11
305,890316962789830656,2017-07-26 21:04:39,14,5,19,False,AAAAAAAAAHHHHHHH,16
306,890315845142028288,2017-07-26 21:00:13,1,0,1,True,@SokruOfficial AAAAAAAHHHH,26
307,890314441937608706,2017-07-26 20:54:38,14,7,21,False,AAAAAAAAAAAAAAAAHHHH,20
308,890313320552701952,2017-07-26 20:50:11,0,0,0,True,@AllesKlar71 AAHHHHHHHHHHHHH,28
309,890311929297817601,2017-07-26 20:44:39,14,4,18,False,AAAAAAAAAAAAAAAAAAAAAAHHHHHHHHHHH,33
310,890309410886746113,2017-07-26 20:34:39,11,1,12,False,AAAAAAAAHHHHHHHHHHHHHHHH,24
311,890307028232679424,2017-07-26 20:25:11,1,0,1,True,@PugsOfRuin AAHHHHHH,20
312,890306894429999105,2017-07-26 20:24:39,10,3,13,False,AAAHHHHHHHH,11
313,890304379340959744,2017-07-26 20:14:39,10,7,17,False,AAAAAAAAAAAAAAAAAH,18
314,890303262179643392,2017-07-26 20:10:13,0,0,0,True,@emsisme AAAAAAAHH,18
315,890303262162919425,2017-07-26 20:10:13,1,0,1,True,@prudentesfuturi AAAAAAAAHHHHHHH,32
316,890301862607564800,2017-07-26 20:04:39,24,17,41,False,AAAAAAAAAAAAAAAAAAAAHHHHHHHHHHHHHHHH,36
317,890299343500185604,2017-07-26 19:54:39,26,12,38,False,AAAAAAAAAAAAHHHHHHHHHHHH,24
318,890296828218023937,2017-07-26 19:44:39,16,12,28,False,AAAAAAAAAAAAAAAAAHHHHHHHHHHHHH,30
319,890295708162695170,2017-07-26 19:40:12,1,0,1,True,@eboldy AAAAAAAAAAAAAAAAAAAHHHHHHHHHHHHH,40
320,890294449481416704,2017-07-26 19:35:12,2,1,3,True,@eboldy AAAAAAAAAAAAAAAAAAAAAHHHHHHHHHH,39
321,890294313665445889,2017-07-26 19:34:39,8,2,10,False,AAAAAAAAAAHHHHHHHH,18
322,890293194809888769,2017-07-26 19:30:13,1,0,1,True,@eboldy AAAAAAAAAAAAAAAAHHHHHHH,31
323,890291795401342977,2017-07-26 19:24:39,13,10,23,False,AAAAAAAAAAAAAAAAAAAHHHHHHHHH,28
324,890289278458228736,2017-07-26 19:14:39,8,5,13,False,AAAAAAAAAAAAAAAHHH,18
325,890286763779993600,2017-07-26 19:04:39,11,2,13,False,AAAAAAAAAAAAAHHHHHHHHH,22
326,890284387362910209,2017-07-26 18:55:13,0,0,0,True,@Ab_Synthia AAAAAAAAAAAAAAHHHH,30
327,890284247524798464,2017-07-26 18:54:39,9,4,13,False,AAAAAAHH,8
328,890281865294303233,2017-07-26 18:45:11,0,0,0,True,@zecmo AAAAAAAHH,16
329,890281730619453441,2017-07-26 18:44:39,13,5,18,False,AAAAAAAAHHHHHH,14
330,890279214225776640,2017-07-26 18:34:39,4,4,8,False,AAAAAAHHHH,10
331,890276695680335872,2017-07-26 18:24:39,4,3,7,False,AAAHHHHH,8
332,890274311872839681,2017-07-26 18:15:11,0,0,0,True,@JDRunning2PhD AAAAHHHHHHHHHH,29
333,890274311797440514,2017-07-26 18:15:11,0,0,0,True,@Jakerbaker58 AAAAAAAAAAAAAAAAAAHHHHHHHHHHHH,44
334,890274180922572802,2017-07-26 18:14:39,17,12,29,False,AAAAAAAAAAAHHHHHHHHHHHHHHHH,27
335,890271660909178882,2017-07-26 18:04:39,8,8,16,False,AAAAAAAAAAAAAHHHHHHHHHH,23
336,890270540476362752,2017-07-26 18:00:11,0,0,0,True,@gringaloca74 AAAAAAAAHHHHHHH,29
337,890270540400820230,2017-07-26 18:00:11,0,0,0,True,@Branthekidmc1 AAAAAAAAAAAAAAAAAAAAAAHHHHHHH,44
338,890269278011830272,2017-07-26 17:55:10,1,0,1,True,@jecascully AAAAAAAAAAAAAAAAAAAAAAAHHHHHHHHHHHH,47
339,890269143685005312,2017-07-26 17:54:38,13,10,23,False,AAAAHHHHHHHHHH,14
340,890266629560512514,2017-07-26 17:44:39,14,22,36,False,AAAAAAAAAAHHHHHHHH,18
341,890264110834778115,2017-07-26 17:34:38,7,3,10,False,AAAAAAHHHHHHHHHHH,17
342,890261596521582596,2017-07-26 17:24:39,16,6,22,False,AAAAAAAAAAAAAAAAAAAAAAHHHHHHHH,30
343,890259077997133830,2017-07-26 17:14:39,6,2,8,False,AAAAAAAAAAAAAAAHHHHH,20
344,890256564900294657,2017-07-26 17:04:39,13,8,21,False,AAAAAAAAAAAAAAAAAAAAAAAHH,25
345,890254044169719808,2017-07-26 16:54:38,7,0,7,False,AAAAAAAHHHHHHHHHHHHHH,21
346,890251663084314624,2017-07-26 16:45:11,1,0,1,True,@djbaggysmalls1 AAAAAAAAAAAAAHHHHHHHHHHHHHH,43
347,890251527230816257,2017-07-26 16:44:38,9,3,12,False,AAAAAAAAAHHHHHH,15
348,890249013093597185,2017-07-26 16:34:39,17,4,21,False,AAAAAAAAAAAHHHHHHHH,19
349,890247893961068544,2017-07-26 16:30:12,1,0,1,True,@Graphospasms AAAHHHHHHHHHHH,28
350,890246495231934465,2017-07-26 16:24:39,15,3,18,False,AAAAAAAAAAAAAAAAAAAAAHHH,24
351,890244111860740098,2017-07-26 16:15:10,0,0,0,True,@Heavysigh72 AAHHHHHHHH,23
352,890243979165532160,2017-07-26 16:14:39,15,7,22,False,AAAAAAAAAAAAAAAAAAAAAAHHH,25
353,890241463677853696,2017-07-26 16:04:39,25,15,40,False,AAAAAAAAAAAAAAAAAAAAAAAHHHHHHHHHHHH,35
354,890238946273357824,2017-07-26 15:54:39,8,1,9,False,AAAAAAAAAHHHH,13
355,890236432937365505,2017-07-26 15:44:40,9,4,13,False,AAAAAHHHHH,10
356,890233915117625345,2017-07-26 15:34:39,9,10,19,False,AAAAAAAAAAAAAHHHHHHHH,21
357,890232794215055360,2017-07-26 15:30:12,0,0,0,True,@CalebHershowitz AAAAAAAAAAAAAAAAAAAAAAH,40
358,890231398266785792,2017-07-26 15:24:39,6,5,11,False,AAAAAAAAHHHHHHH,15
359,890229011816861697,2017-07-26 15:15:10,0,0,0,True,@AMRINDE22975124 AAAAAAAAAAAAAAAAAAAAHHHHHHHHHHHH,49
360,890228881927569408,2017-07-26 15:14:39,9,7,16,False,AAAAAAAAAAHHHHHHHHHHHHH,23
361,890226498732478464,2017-07-26 15:05:11,1,1,2,True,@lilbrewdog AAAAAAAAAAAAAAAAAAAAAAHHHH,38
362,890226365211049984,2017-07-26 15:04:39,14,11,25,False,AAAAAAAAAAAAAAAAAAAHHHHHH,25
363,890225248007856130,2017-07-26 15:00:13,1,0,1,True,@amageles AH,12
364,890223982364045312,2017-07-26 14:55:11,0,0,0,True,@NattyJPuffinton AAAAAAAAAAAAAAAAHHHHHHHHHHHHHHH,48
365,890223849547149314,2017-07-26 14:54:39,6,7,13,False,AAAAAAAAAAAAAAHHHHHHHH,22
366,890222728585916417,2017-07-26 14:50:12,0,0,0,True,@CharlesDardaman AAAAAAHHHHHH,29
367,890221329705824256,2017-07-26 14:44:39,31,26,57,False,AAAAAAAAAAAAAAAAAAAAAAHHHHHHHHHHHHHH,36
368,890220210204135424,2017-07-26 14:40:12,0,0,0,True,@SngleMaltWhimsy AAAAAAAAAAAAAAAAAAHHHHHHHHHHHH,47
369,890218947475386369,2017-07-26 14:35:11,1,0,1,True,@cgriebel AHHHHHHHHHHHHH,24
370,890218812657815553,2017-07-26 14:34:39,23,15,38,False,AAAAAAAAAAHHHHHHHHHHH,21
371,890216429697499136,2017-07-26 14:25:10,0,0,0,True,@laurahelmuth AAAAAAAAH,23
372,890216298340380672,2017-07-26 14:24:39,7,2,9,False,AHHHHHHH,8
373,890213782236147713,2017-07-26 14:14:39,16,7,23,False,AAAAAAAAAAAAAHHHHHHHHHHHH,25
374,890211264672215040,2017-07-26 14:04:39,22,20,42,False,AHHHHHHHHHHHHHH,15
375,890210143681597440,2017-07-26 14:00:12,1,0,1,True,@peoplepersson AAAAAAAHHHHHHHHHHHHHHHH,38
376,890208747041304576,2017-07-26 13:54:39,9,3,12,False,AAAAAAAAHHHHHHHHHH,18
377,890207624595214336,2017-07-26 13:50:11,1,0,1,True,@maherwalsh AAAAAHHHHHHHHH,26
378,890206230433738752,2017-07-26 13:44:39,10,7,17,False,AAAAAAHHHHHH,12
379,890205109946372097,2017-07-26 13:40:12,0,0,0,True,@scienceovermyth AAAAAAAHHHHH,29
380,890203850841489409,2017-07-26 13:35:11,0,0,0,True,@FritSlang AAAAAAAAAAAAAAAAAHHHHHHHHHHHHHHHH,44
381,890203714379755520,2017-07-26 13:34:39,14,5,19,False,AAAHHHHHHHH,11
382,890201196467818497,2017-07-26 13:24:39,19,14,33,False,AAAAAAAAAAAAAAAAAHHHHH,22
383,890198679218507776,2017-07-26 13:14:38,31,26,57,False,AAAAAAAAAAAAAAAAAHHHHHHHHHHH,28
384,890196166813634560,2017-07-26 13:04:39,9,2,11,False,AAHHHHHHHHHHHHH,15
385,890193651468513280,2017-07-26 12:54:40,3,4,7,False,AAAHHHHHHH,10
386,890191133053202433,2017-07-26 12:44:39,4,5,9,False,AAAAAAAAAAAHHHHHHHHHHH,22
387,890188616856731649,2017-07-26 12:34:39,9,6,15,False,AAAAAAAHHHHHHHHHHHHH,20
388,890186100152684545,2017-07-26 12:24:39,9,4,13,False,AAAAAAAAAAAAAAHHHHHHHHHHHHH,27
389,890184980730699777,2017-07-26 12:20:12,0,0,0,True,@Aiman_1_Gamer AAAAAAAAAAAAAHHHHHHHHHHHH,40
390,890183582597214209,2017-07-26 12:14:39,9,4,13,False,AAAAAAAAAAAAH,13
391,890181198454063104,2017-07-26 12:05:11,0,0,0,True,@Securitrees AAAAAAAAAAAAAAAAAHHHHHHHHHHHHHHHH,46
392,890181064483799040,2017-07-26 12:04:39,5,5,10,False,AAAAAAAAAAAAAAAHHHHHHHHHH,25
393,890179947121303553,2017-07-26 12:00:12,0,1,1,True,@MacWilliams3 AAAAAAAAAAAAAAAAAAHH,34
394,890178547096190976,2017-07-26 11:54:39,8,4,12,False,AAAAAAAAAAAAAAAAAAAAAAAHHHH,27
395,890176032656982016,2017-07-26 11:44:39,4,0,4,False,AAAAAHHHHHHHHH,14
396,890173514640220160,2017-07-26 11:34:39,6,4,10,False,AAH,3
397,890170998363959296,2017-07-26 11:24:39,16,4,20,False,AAAAAAAAAAAAAAAAAAHHHHHHHHHH,28
398,890168482083614720,2017-07-26 11:14:39,8,3,11,False,AAAAAAAAAAAAAAAAHHHHHHHHHHHHHH,30
399,890165966184882176,2017-07-26 11:04:39,7,0,7,False,AAAAAHHHHHH,11
400,890163448440647680,2017-07-26 10:54:39,7,8,15,False,AAAAAAAAAAAAAAAAAAAAAAAHHHHHHHHHHHHHHH,38
401,890162327156391936,2017-07-26 10:50:11,0,0,0,True,@mikekrolik AAAAAAHHHHHHHHHHHHHHH,33
402,890160935121408000,2017-07-26 10:44:39,6,1,7,False,AAAAAAAAAAAAAAHHHH,18
403,890158416827645952,2017-07-26 10:34:39,12,3,15,False,AAAAAAAAAAAAAAAAAAAAHH,22
404,890155901809807361,2017-07-26 10:24:39,7,0,7,False,AAAAAAAAAAAAAAAAAAAHHHHHHHHHHH,30
405,890153381779697665,2017-07-26 10:14:39,4,1,5,False,AAAHHHHHHHHHHH,14
406,890150864769384449,2017-07-26 10:04:39,5,1,6,False,AAAAAAAHHHHHHHHHH,17
407,890148350233894912,2017-07-26 09:54:39,1,1,2,False,AAAAAAAAAAAAAAAAHHHHHHHHHHHHH,29
408,890145831759859712,2017-07-26 09:44:39,3,2,5,False,AAAAAAAAAAAAAAAAAAAAAHHHHHHHHH,30
409,890143317459177472,2017-07-26 09:34:39,4,4,8,False,AAAAAAAAAAAAHHHHHH,18
410,890140800771928064,2017-07-26 09:24:39,9,7,16,False,AAAAAAAAAAAAAAAAAAHHHHHHHHHHHHHH,32
411,890138282067193861,2017-07-26 09:14:39,9,7,16,False,AAAAAAAAAAAAAAAAAAAAAHHHHHHHHHHH,32
412,890135767519035392,2017-07-26 09:04:39,9,8,17,False,AAAAAAAAAAAAAAHHHHHHH,21
413,890133249992908800,2017-07-26 08:54:39,8,0,8,False,AAAAAAAAAHHHHH,14
414,890132128721248262,2017-07-26 08:50:11,0,0,0,True,@cabarkk AAAAAAAAAAAAAAAAAAAAAHH,32
415,890130733720899584,2017-07-26 08:44:39,8,2,10,False,AAAAAAAAAAAAAAAAAAAHHHH,23
416,890128216110792706,2017-07-26 08:34:39,4,2,6,False,AAHHHHHHHHH,11
417,890125700090540032,2017-07-26 08:24:39,4,3,7,False,AAAAAAAAAAHHHHHHH,17
418,890123186649616384,2017-07-26 08:14:40,6,3,9,False,AAAAAAAAAAAAAAHHHHH,19
419,890120669295464448,2017-07-26 08:04:39,5,2,7,False,AAAAAAAAAAAH,12
420,890118286347821056,2017-07-26 07:55:11,0,0,0,True,@Ab_Synthia AAAHHHHHHHHHHHHHH,29
421,890118286293303297,2017-07-26 07:55:11,0,0,0,True,@SE25A AAAH,11
422,890118151899414529,2017-07-26 07:54:39,3,1,4,False,AAAAAHHH,8
423,890115768909795328,2017-07-26 07:45:11,0,0,0,True,@ReaganiteGOPer AAAAAAAAHHHHHHH,31
424,890115634775961600,2017-07-26 07:44:39,7,13,20,False,AAAAAAAAAAAAAAAAAAAAAHHHHHHHH,29
425,890113118445109249,2017-07-26 07:34:39,2,1,3,False,AAAAAAAHHHHHHHHH,16
426,890110733962358784,2017-07-26 07:25:11,0,0,0,True,@Ab_Synthia AAAAAAAAAAAAAAAAAAAAAAAHHHHH,40
427,890110600180887552,2017-07-26 07:24:39,5,2,7,False,AAAHH,5
428,890109482184867840,2017-07-26 07:20:12,0,0,0,True,@Ab_Synthia AAAAAAAHHHHHHHHH,28
429,890109482159792129,2017-07-26 07:20:12,0,0,0,True,@andrewdee03 AAAAAHHHHHHHH,26
430,890108085351612417,2017-07-26 07:14:39,8,9,17,False,AAAAAAAAAAAAAAAAAAAAHHHHHHHHH,29
431,890105569977171979,2017-07-26 07:04:39,4,4,8,False,AAAAAAAHHHHHHHHHHHH,19
432,890104454892195845,2017-07-26 07:00:14,0,0,0,True,@sangwij AAAAAAAAAAAAAAAAHHHHHHHHHH,35
433,890103055596867588,2017-07-26 06:54:40,7,8,15,False,AAAAAAAAAAAAAAAAAAAAHHHHHHHHHHH,31
434,890100536007151616,2017-07-26 06:44:39,2,3,5,False,AAAAAHHHHHHHH,13
435,890098020167057408,2017-07-26 06:34:39,6,4,10,False,AAAAAAAAHH,10
436,890095502380986368,2017-07-26 06:24:39,3,0,3,False,AAAAAAAHHHHH,12
437,890092986801025025,2017-07-26 06:14:39,13,3,16,False,AAAAAAAAAAAAAAAAHHHHHHHHHHHHH,29
438,890090469866209281,2017-07-26 06:04:39,6,5,11,False,AAAAHHHHHHHHHHHHHHHH,20
439,890087951262257152,2017-07-26 05:54:39,2,2,4,False,AAAAAAAAAAAAHH,14
440,890085436391075842,2017-07-26 05:44:39,5,2,7,False,AAAAAAAAAAAHHH,14
441,890082917875146752,2017-07-26 05:34:39,14,16,30,False,AAAAAAAAAAAAAAAAAAAAAAAHHHHHHHHHHHHH,36
442,890081796817383425,2017-07-26 05:30:11,0,0,0,True,@kellydraper AAAAAAAAAAAAAAAAAAAAHHHHHHHHHHHHHHH,48
443,890080402278424576,2017-07-26 05:24:39,19,10,29,False,AAAAAAAAAAAAAAHHHHHHHHHHHHHHH,29
444,890078017988567042,2017-07-26 05:15:10,1,0,1,True,@JennyGoodwinLav AAAAHHHHHHHHHHHHHH,35
445,890077884748050432,2017-07-26 05:14:39,6,6,12,False,AAAAAAAHHHH,11
446,890075371323961344,2017-07-26 05:04:39,13,8,21,False,AAHH,4
447,890072851411238912,2017-07-26 04:54:39,14,6,20,False,AAAAAAAAAAAAAAAAAHHHHHHHHHHHH,29
448,890070335604785152,2017-07-26 04:44:39,8,2,10,False,AHHHH,5
449,890069213372710913,2017-07-26 04:40:11,0,0,0,True,@stormresist2017 AAAAAAHHHHHHHH,31
450,890067820893138944,2017-07-26 04:34:39,9,1,10,False,AAAAAAAAAAHHHHHHHHH,19
451,890065437245005824,2017-07-26 04:25:11,1,0,1,True,@brando5112 AAAAHHHHHHHHHHHH,28
452,890065303664832513,2017-07-26 04:24:39,13,5,18,False,AAAAAAAAAAAAAAAAAAHHHHHHHHHHHH,30
453,890062785513758720,2017-07-26 04:14:39,15,5,20,False,AAAAAAAAAAAAAAAAAAAAHHHHHHHH,28
454,890060403920834565,2017-07-26 04:05:11,1,0,1,True,@pattersonjeffa AHHHHHHHHHHHHH,30
455,890060270177062912,2017-07-26 04:04:39,19,11,30,False,AAAAAAAAAAAAAAAAAAAAAAAHHHHHHHHH,32
456,890057753829539841,2017-07-26 03:54:39,9,3,12,False,AHHHHHHHHHH,11
457,890055234151698432,2017-07-26 03:44:38,14,2,16,False,AAAHHHHHHHHHH,13
458,890052854886670336,2017-07-26 03:35:11,0,0,0,True,@tina_boll AAAAAAAAAAAAAAHHHHHHHHHHH,36
459,890052721130319872,2017-07-26 03:34:39,17,2,19,False,AAHHHH,6
460,890051598889758721,2017-07-26 03:30:12,2,0,2,True,@gus_posey AAHHHHHHHHHHHHH,26
461,890050201817370624,2017-07-26 03:24:39,22,9,31,False,AAAAAAAAAAHHHHHHHHHHHHHH,24
462,890047684371001345,2017-07-26 03:14:38,31,15,46,False,AAAAHHHHHHHHH,13
463,890045171974496256,2017-07-26 03:04:39,10,3,13,False,AAAAH,5
464,890042654003793920,2017-07-26 02:54:39,23,11,34,False,AAAAAAAAAAAAAAAAAAAAAAHHHHHHHHHHHHH,35
465,890041531343745027,2017-07-26 02:50:11,1,0,1,True,@l_vijay AAAAAAAAAAAAAAAAAAHHH,30
466,890040137111003136,2017-07-26 02:44:39,21,9,30,False,AAAAAAAAAAAAAAAAAAAAAAAHHHHHHHHHHHHHHH,38
467,890039016128688129,2017-07-26 02:40:12,1,0,1,True,@ChristinLuvsSno AAAAAAAAAAAAAAAAAAAHHH,39
468,890037619035447296,2017-07-26 02:34:39,22,7,29,False,AAAAAAAAAAAAAAAAAAAHHHHHH,25
469,890035103098974209,2017-07-26 02:24:39,17,10,27,False,AAAAAAAAAAAAAHHHHHHHHHHHHHH,27
470,890032587640643584,2017-07-26 02:14:39,6,0,6,False,AAAAAHH,7
471,890030072031215616,2017-07-26 02:04:39,13,9,22,False,AAAAAAAAAAAHHHHHHHHHHHHHHHH,27
472,890027552613568512,2017-07-26 01:54:39,12,4,16,False,AAAAAHHH,8
473,890025172132139008,2017-07-26 01:45:11,0,0,0,True,@defectiveMom AAAAAAAAAAAAAAAH,30
474,890025036714790912,2017-07-26 01:44:39,7,6,13,False,AAAAAAAAAHH,11
475,890023915287982080,2017-07-26 01:40:11,0,0,0,True,@JenHartling AAAAAAAAAAAAHH,27
476,890022521625595906,2017-07-26 01:34:39,11,8,19,False,AAAAAAAAAAAAAAAAHHHHHHHHHH,26
477,890021400525897728,2017-07-26 01:30:12,1,0,1,True,@defectiveMom AAAAAAAAAAAAAAAAAAAAAAAHHHH,41
478,890020003243859969,2017-07-26 01:24:39,15,5,20,False,AAAAAAAAAAAAAAAAAAHHHHHHHHHHHHHHHH,34
479,890017620359086080,2017-07-26 01:15:11,0,0,0,True,@bracing AAAAAAAAAAAAAAHHHHHHHHH,32
480,890017488209145857,2017-07-26 01:14:39,10,2,12,False,AAAAAAAAAHHHHHHHHHHHHHHH,24
481,890015106897240066,2017-07-26 01:05:11,0,0,0,True,@lovablemarketer AAAAAAAAAAAAAAAAAAAAAAAHHHHHHHHHHHH,52
482,890014971509321729,2017-07-26 01:04:39,15,6,21,False,AAAAAAAAAAHHHHHHHHHHHHHHHH,26
483,890013859112771585,2017-07-26 01:00:14,0,0,0,True,@smp00 AAAAAAAAAAAAAAAAAAAAHH,29
484,890012453479862272,2017-07-26 00:54:39,25,13,38,False,AAAAAAAAAAAAAAAAAAAAAHHHHHHHHHHHHH,34
485,890011332191420419,2017-07-26 00:50:11,1,0,1,True,@defectiveMom AAHHHHHHH,23
486,890009937321111552,2017-07-26 00:44:39,11,3,14,False,AAAAAAHHHHHHHHHHHHH,19
487,890007420738646016,2017-07-26 00:34:39,24,17,41,False,AAAAAAAAAAAAAAAAAAAAAHHHHHHHHHHHHHHHH,37
488,890004902465949697,2017-07-26 00:24:38,22,13,35,False,AAAAAAAAAAAAAAAAAAAAHHHHHHHHHHHHHHHH,36
489,890002386458169344,2017-07-26 00:14:39,9,1,10,False,AAAAAAAAAHHHH,13
490,890000006102568960,2017-07-26 00:05:11,1,0,1,True,@scienceovermyth AAHHH,22
491,889999874221060096,2017-07-26 00:04:40,4,3,7,False,AAAAAAHH,8
492,889997353553453056,2017-07-25 23:54:39,15,5,20,False,AAAAAAAAAAAAAAAAHHHHH,21
493,889994839584116737,2017-07-25 23:44:39,8,4,12,False,AAAAAAAAHHHHHHHHH,17
494,889992456170872833,2017-07-25 23:35:11,0,0,0,True,@djbaggysmalls1 AAAAAAAAAAAAAHHHHH,34
495,889992320413818880,2017-07-25 23:34:39,9,4,13,False,AAAAAAAH,8
496,889991198596837380,2017-07-25 23:30:11,0,0,0,True,@TBRLozano AAAAAAAAAAAAAAAAAHHHHHHH,35
497,889989807056793601,2017-07-25 23:24:39,7,1,8,False,AAAAAAAAAAAAAHHHHHHHH,21
498,889987289379745792,2017-07-25 23:14:39,13,6,19,False,AHH,3
499,889986171157319680,2017-07-25 23:10:13,0,0,0,True,@HmpJack AAAAAAAAAAAAAHHH,25
500,889986171132096516,2017-07-25 23:10:12,0,0,0,True,@SofiaFawley_ AAAAAAAAAAAAAAAAAAHHHHHHHHHHHH,44
501,889984773476810755,2017-07-25 23:04:39,18,12,30,False,AAAAAAAAAAAAAAAAAAHHHH,22
502,889982254641971201,2017-07-25 22:54:39,8,5,13,False,AAAAAAAAAAAAAAAAAAAAAAHH,24
503,889979739225690114,2017-07-25 22:44:39,13,4,17,False,AAAAAHHHHHH,11
504,889977356097662976,2017-07-25 22:35:11,0,0,0,True,@lad_lew AAAAAAAAAAAAAAAAAAAAAAH,32
505,889977223184252929,2017-07-25 22:34:39,12,3,15,False,AAAAAAAAAAHHHHHHHHHHH,21
506,889976101753294848,2017-07-25 22:30:12,0,0,0,True,@TabbyChaps AAAAAAAAAAAAAAAAAAHHHH,34
507,889974707038150656,2017-07-25 22:24:39,12,5,17,False,AAAAAHHHHHHHHHHHHHHH,20
508,889972323209621505,2017-07-25 22:15:11,0,0,0,True,@EmmaLee05733408 AAAAAAAAAAH,28
509,889972188580859904,2017-07-25 22:14:39,7,2,9,False,AAAAAAAAAHHHHH,14
510,889971071818096648,2017-07-25 22:10:13,1,1,2,True,@keepyalifeyours AAAAAAAHHHHHHHHH,33
511,889969672002707457,2017-07-25 22:04:39,11,2,13,False,AAAAAAHHHHHHHHHHHH,18
512,889968554447163392,2017-07-25 22:00:12,1,0,1,True,@PantherSherry AAAAAAAAAAAAAAAAAAAAHHHHHHHHHHHHHHHH,51
513,889967155302846464,2017-07-25 21:54:39,25,14,39,False,AAAAAAAAAAAAAAAHHHHHHHHHHHHHHHH,31
514,889964639328579584,2017-07-25 21:44:39,11,3,14,False,AAAAAAAAAAAAAAAAAH,18
515,889962124780482561,2017-07-25 21:34:39,7,4,11,False,AAH,3
516,889961024379654145,2017-07-25 21:30:17,0,0,0,True,@Carablades AAAAAAAAAAAAAAAHHHHHHHHHHHH,39
517,889959606163824641,2017-07-25 21:24:39,16,5,21,False,AAAAHHHHHHH,11
518,889958486855102465,2017-07-25 21:20:12,1,0,1,True,@waitworry AAAHHHH,18
519,889957222389870592,2017-07-25 21:15:11,0,0,0,True,@ashawoodhouse AAAAAAHH,23
520,889957089996656640,2017-07-25 21:14:39,10,4,14,False,AAHHHHHHHHHH,12
521,889955968867594240,2017-07-25 21:10:12,0,0,0,True,@NoraReed AAAAAAAAAAAAAAAAAAH,29
522,889954572336332801,2017-07-25 21:04:39,16,12,28,False,AAAAAAAAAAAAAAAAAAAAHHHHHHHHHHHHHH,34
523,889952054806028291,2017-07-25 20:54:39,11,6,17,False,AHHHHHHHHHHHHHH,15
524,889949538856951809,2017-07-25 20:44:39,39,22,61,False,AAAAAAAAAAAAAAAAAAAAAAAHHHHHHHHHHHHHH,37
525,889947022874353664,2017-07-25 20:34:39,34,18,52,False,AAAAAAAAAAAAAAAAAHHHHHHHHHHHHH,30
526,889945907353059328,2017-07-25 20:30:13,1,0,1,True,@bus2201 AAAAAAAAAAAAAAAAAAAAAAAHHHHHH,38
527,889944506778386432,2017-07-25 20:24:39,7,3,10,False,AAHHH,5
528,889942126359871489,2017-07-25 20:15:11,4,1,5,True,@magpie AAAAAAAAAAAAAAAAAAAAAHHHHHHHHHHHHH,42
529,889942126326427653,2017-07-25 20:15:11,1,0,1,True,@magpie AAAAAAAAAAAAAAAAAAAHHHHHHHHHHHHHH,41
530,889941992960135168,2017-07-25 20:14:40,17,19,36,False,AAAAAAAAAAAAAAAHHHHHH,21
531,889940876608360448,2017-07-25 20:10:13,2,0,2,True,@jumbledandjivey AAAAAAAAAAAAAAAAHHHHHHHHHHHHHHHH,49
532,889939473617874945,2017-07-25 20:04:39,10,13,23,False,AAAAHHH,7
533,889936954883702784,2017-07-25 19:54:38,20,17,37,False,AAAAAAAAAAAAAAAAAAH,19
534,889934574633058307,2017-07-25 19:45:11,1,0,1,True,@filmceri AAAAAAAAAAAAAAAAAAAHHHHHHHHHHHHHHHH,45
535,889934440788570112,2017-07-25 19:44:39,17,15,32,False,AHHHHHHHHHHHHHHHH,17
536,889931923862290432,2017-07-25 19:34:39,26,35,61,False,AAAAAAAAAAAAAAAAAAAAHHHHHHHHHHHH,32
537,889929408462688257,2017-07-25 19:24:39,24,27,51,False,AAAAAAAAHHHHHHHHHH,18
538,889926890823323648,2017-07-25 19:14:39,14,3,17,False,"AAAAAAAAAHHHHHHHHHHHHH 
https://t.co/aofN6lUDJJ",47
539,889924512837513217,2017-07-25 19:05:12,2,0,2,True,@THuelskoetter AAAAAAAAAAAAAAAAAAAAAH,37
540,889924512623493122,2017-07-25 19:05:12,9,0,9,True,@ClayDemigoddess AAAAAAAAAAAAAAAAAAAAHHHHHHHHH,46
541,889924374958141440,2017-07-25 19:04:39,33,51,84,False,AAAAAAAAAAAAAAAAAAHHHHH,23
542,889923265690554368,2017-07-25 19:00:15,1,0,1,True,@clefabledude AAAAAAAAAAAAAAAAAAAAAAAHHHHHHHHH,46
543,889922000168386561,2017-07-25 18:55:13,1,0,1,True,@clefabledude AAAAAAAAAAAAAAAAAAAAAAHHH,39
544,889921858774204416,2017-07-25 18:54:39,26,27,53,False,AAHHHHHHHHHHHHHHH,17
545,889919474568241156,2017-07-25 18:45:11,7,0,7,True,@ClayDemigoddess AAAAAHHHHHHHHHHH,33
546,889919474509524998,2017-07-25 18:45:11,0,0,0,True,@monopod AAAAAAAAAHHHHHHHHHHHHHHH,33
547,889919340858023937,2017-07-25 18:44:39,18,20,38,False,AAAAHHHHHH,10
548,889916826611851264,2017-07-25 18:34:39,24,25,49,False,AAAAAAAAAAAAAAAHHHHH,20
549,889914307823239172,2017-07-25 18:24:39,11,14,25,False,AAAAAAAAAAHHHHHHHHHHHHHHHH,26
550,889911793375748096,2017-07-25 18:14:39,13,6,19,False,AAAAAAAAAAAAAAAAAAHHHHHHHH,26
551,889910674763264000,2017-07-25 18:10:13,2,1,3,True,@teneikona AAAAAAAHHHHHHHHH,27
552,889910674746474497,2017-07-25 18:10:13,3,0,3,True,@LaceyDancingFox AAAAAAAAHHHHHHHHH,34
553,889909273685372931,2017-07-25 18:04:39,20,23,43,False,AAAAAAHHHHHHHHHHHHHHH,21
554,889906759590191105,2017-07-25 17:54:39,11,7,18,False,AAAAAAAAAAAAAAAAAAAAAAHHHH,26
555,889904241237794816,2017-07-25 17:44:39,10,2,12,False,"AAAAAAAAAAAAAAAHHHHHHH 
https://t.co/yV4Viu5hXX",47
556,889901725808775169,2017-07-25 17:34:39,5,1,6,False,AAAHHHH,7
557,889899208563716098,2017-07-25 17:24:39,7,1,8,False,AAAAAAAAAAAAAAAHHHHHHH,22
558,889898090500677634,2017-07-25 17:20:12,0,0,0,True,@The_MMU AAAAAAAAAHHHHHHHHHHH,29
559,889896690534297605,2017-07-25 17:14:39,3,3,6,False,AAAAAAAAAAAAHHHHHHHH,20
560,889894175294054402,2017-07-25 17:04:39,2,0,2,False,AAAAAAHHHHHH,12
561,889893058141138945,2017-07-25 17:00:13,0,0,0,True,@Kristenthann AAAAAAAAAAAAAAAAAAAAAHHHHHHHHHHH,46
562,889893058120232961,2017-07-25 17:00:13,0,0,0,True,@PaulGatto AAHHHH,17
563,889891659269500929,2017-07-25 16:54:39,6,7,13,False,AAAAAAAAAAAAAAAAAAAAHHHH,24
564,889889143655981057,2017-07-25 16:44:39,8,8,16,False,AAAAAAAAAAAAAAHHHHHH,20
565,889886625018380288,2017-07-25 16:34:39,10,3,13,False,AAAAAAAAAAAAAAAAAAAAAHHHH,25
566,889884108217831425,2017-07-25 16:24:39,10,2,12,False,AAAAAAAAAAAAAAAAHH,18
567,889881590599491584,2017-07-25 16:14:39,8,6,14,False,AAAAAAAAAAAAAAAAAAAAAHHHHHHHHH,30
568,889879074428112897,2017-07-25 16:04:39,4,3,7,False,AAAAAAAAAAHHHHHHHH,18
569,889876700942794755,2017-07-25 15:55:13,0,0,0,True,@CindyRobeck AAAAAAAAAAHHHH,27
570,889876560567832579,2017-07-25 15:54:39,1,0,1,False,AAAHHHHH,8
571,889874176818991106,2017-07-25 15:45:11,0,0,0,True,@FalconGrrrl AAAAAAAAAAAAAAAAAHHHHHHHH,38
572,889874044505526272,2017-07-25 15:44:39,5,2,7,False,AAAAAAAAAAAAHHHHHHHHH,21
573,889872926983454720,2017-07-25 15:40:13,1,1,2,True,@FalconGrrrl AAAAAAAAAAAAHHHHHH,31
574,889871661327147009,2017-07-25 15:35:11,1,0,1,True,@nickitweety82 AAAAAAAAAAAAAAAAAAAHHHHHHH,41
575,889871661310377985,2017-07-25 15:35:11,3,0,3,True,@noahkalina AAAAAAAAAAAAAAAH,28
576,889871526438240257,2017-07-25 15:34:39,5,0,5,False,AAAAAAAAAAAAH,13
577,889870427883020288,2017-07-25 15:30:17,0,0,0,True,@twmadden4 AH,13
578,889869010992599041,2017-07-25 15:24:39,6,4,10,False,AAAHHHHHHHHHHHH,15
579,889866492619235329,2017-07-25 15:14:39,19,11,30,False,AAAAAAAAAAAAAAAAAAAAAAAHHHHHHHHHHHH,35
580,889863977995579392,2017-07-25 15:04:39,6,2,8,False,AAAAAAAAAAAAAAHHHHHHHHHHHHH,27
581,889861458061910016,2017-07-25 14:54:39,12,9,21,False,AAAAAAAAAAHHHHHHHHHHHHH,23
582,889858942536384513,2017-07-25 14:44:39,11,4,15,False,AAAAAAAAAAAAAAAAHHHH,20
583,889856425882775554,2017-07-25 14:34:39,9,1,10,False,AAAHHHHHH,9
584,889853907580710912,2017-07-25 14:24:38,7,2,9,False,AAAAAAAAAAAAAHH,15
585,889851393582010368,2017-07-25 14:14:39,16,15,31,False,AAAAAAAAAAAAAAAAAAAAAAHHHHHHHHHHHHH,35
586,889848880174596096,2017-07-25 14:04:40,12,3,15,False,AAAAAAAAHH,10
587,889847800850153472,2017-07-25 14:00:22,0,0,0,True,@MTKsf AAAAAAAAHHHH,19
588,889846360366862336,2017-07-25 13:54:39,6,3,9,False,AAAAAHH,7
589,889843843360849921,2017-07-25 13:44:39,3,1,4,False,"AAAAAAAAAAAHHHH 
https://t.co/h23hgBJBeD",40
590,889838801010511872,2017-07-25 13:24:37,18,11,29,False,AAAAAAAAAAAAAAAAAAAHHHHHH,25
591,889837693533913088,2017-07-25 13:20:13,0,0,0,True,@defectiveMom AAAAAHHHHHHHHHHHHHHHH,35
592,889836285434769408,2017-07-25 13:14:37,9,3,12,False,AAAAHHHH,8
593,889833768680292352,2017-07-25 13:04:37,8,3,11,False,AAAAAAAAAHHH,12
594,889831255285616641,2017-07-25 12:54:38,9,2,11,False,AAAAAAAAAAHHHHHHHHHHHH,22
595,889830150124310528,2017-07-25 12:50:14,0,0,0,True,@DeepStateUSA AAAAAAAAAAAAAAAAAAAAAHHHHHHHHH,44
596,889828733703647232,2017-07-25 12:44:36,10,5,15,False,AAAAAAAAAAAAAAAAHHHHHHHHH,25
597,889826219235192832,2017-07-25 12:34:37,15,2,17,False,AAAAAAAAAAAHHHHHHHH,19
598,889823701528707072,2017-07-25 12:24:37,5,1,6,False,AAAAAAAAAAAAHHHHH,17
599,889821186279997442,2017-07-25 12:14:37,11,2,13,False,AAAAAAAAAAAAAAAAAAAAAAH,23
600,889818671677415426,2017-07-25 12:04:38,15,4,19,False,AAAAAAAAAAAAAAHHHHHHHHHHHHHH,28
601,889816153278877698,2017-07-25 11:54:37,14,7,21,False,AAAAAAAAAAAAAAAAAAAAAAHHHHHHH,29
602,889813635886960641,2017-07-25 11:44:37,10,3,13,False,AAAAHHHHHHHHHHHHHHH,19
603,889811118809632772,2017-07-25 11:34:37,13,7,20,False,AHHHHHHHHHHHHHHH,16
604,889808601757491204,2017-07-25 11:24:37,7,3,10,False,AAAAAAAAHHHHHH,14
605,889806084826910721,2017-07-25 11:14:37,5,2,7,False,AAAAAAAAAAAAAAAAAAHHHHHHHHHH,28
606,889803569062432768,2017-07-25 11:04:37,7,7,14,False,AAAAAAAAAAAAAAHH,16
607,889801053444681728,2017-07-25 10:54:37,18,14,32,False,AAAAAAAAAAAAAAAAAAAAAAHHHHHHHHH,31
608,889798537218805760,2017-07-25 10:44:37,11,8,19,False,AAAAAAAAAAAAAAAAAAAAAH,22
609,889796021882146816,2017-07-25 10:34:37,6,3,9,False,AAHHHHHHHHHHHHHHHH,18
610,889793504062451712,2017-07-25 10:24:37,10,8,18,False,AAAAAAAAAAAHHHHHHHHHHHHHHHH,27
611,889790988092309504,2017-07-25 10:14:37,13,7,20,False,AAAAAAAAHHHHHHHHHHHHH,21
612,889788471862321153,2017-07-25 10:04:37,8,3,11,False,AAAAAAAAAAH,11
613,889785951349854208,2017-07-25 09:54:36,9,3,12,False,AAAAAAAAAAAAAHHHHHHHH,21
614,889783437393104896,2017-07-25 09:44:37,8,2,10,False,AAAAAAAAAAAH,12
615,889782332152066049,2017-07-25 09:40:13,1,0,1,True,@cte6ah AAAAAAAAAAAAAAAAAAAAH,29
616,889782332114296833,2017-07-25 09:40:13,1,0,1,True,@glorphindale AAAAHHHHHHHH,26
617,889782332063928320,2017-07-25 09:40:13,1,0,1,True,@glorphindale AHHHHHHHH,23
618,889780919351078913,2017-07-25 09:34:37,7,0,7,False,AAAAHHHHHHHHH,13
619,889778402844082176,2017-07-25 09:24:37,11,2,13,False,AAAAAAAAAAAAAAAAAHHHHH,22
620,889775887444566016,2017-07-25 09:14:37,7,2,9,False,AAAAAAAAAAAHHHHHHHHHHHHHH,25
621,889773371868708864,2017-07-25 09:04:37,6,0,6,False,AAAAAAAAAAAAAAAAAAAAAAAHH,25
622,889770856183943169,2017-07-25 08:54:37,6,1,7,False,AHHHHHHHHHHHH,13
623,889768335088517120,2017-07-25 08:44:36,11,4,15,False,AAAAAAAAAAAAAAAAAAAHHHHHHHHHHHHHHH,34
624,889765820640841728,2017-07-25 08:34:37,7,2,9,False,AAAAAAAAAHHHH,13
625,889763305878941696,2017-07-25 08:24:37,7,1,8,False,AAAAAAAAHHHHHHHHHHHHHHH,23
626,889760786775724033,2017-07-25 08:14:37,5,0,5,False,AAAAAAAAAAAAAAHHHHHHHHHHHHHHH,29
627,889758270474379266,2017-07-25 08:04:37,5,3,8,False,AAHHHHH,7
628,889755755473248256,2017-07-25 07:54:37,11,2,13,False,AAAAAAAAAAAAAAAAAAAAAAAHHHH,27
629,889753239121481728,2017-07-25 07:44:37,15,10,25,False,AAAAAAAAAAAAAAAAAAAAAHHHHHHHHHH,31
630,889750722161643522,2017-07-25 07:34:37,13,4,17,False,AAAAAAAAAAAAAAAHHHHHHHHHHHHH,28
631,889748202861318145,2017-07-25 07:24:36,17,11,28,False,AAAAAAAAAAAAAAAAAAAAAAAHHHHHH,29
632,889745690674569219,2017-07-25 07:14:37,6,5,11,False,AAAAAAAAAAAAHHHHHHHHHHHHH,25
633,889743171672035328,2017-07-25 07:04:37,8,2,10,False,AAHHHHHH,8
634,889740656356319232,2017-07-25 06:54:37,11,2,13,False,AAAAAAAAAAAAAAAHHHHHHHHHH,25
635,889738139421618177,2017-07-25 06:44:37,7,0,7,False,AHHHHHHHHH,10
636,889737028409184256,2017-07-25 06:40:12,1,0,1,True,@NikaDragomira AAAAAAAAAAAAAHHHHHHHHHHH,39
637,889737028316909570,2017-07-25 06:40:12,0,0,0,True,@MessyTheMeme AAAAAAAAAAAAAAAAAAHHHHHHHHHHHHHH,46
638,889737028295954432,2017-07-25 06:40:12,0,0,0,True,@MessyTheMeme AHHHHH,20
639,889737028274925568,2017-07-25 06:40:12,1,1,2,True,@andreacurry AHHHHHH,20
640,889735763407106048,2017-07-25 06:35:11,0,0,0,True,@MessyTheMeme AAAAAHHHH,23
641,889735623120232448,2017-07-25 06:34:37,5,0,5,False,AAAAAAAHHHHHHH,14
642,889734530952818688,2017-07-25 06:30:17,0,0,0,True,@MessyTheMeme AAAHHHHHHHH,25
643,889734530940248064,2017-07-25 06:30:17,1,0,1,True,@Cherylkartist AAAHHHH,22
644,889733252923174912,2017-07-25 06:25:12,0,0,0,True,@MessyTheMeme AAAAAAAAAHHHH,27
645,889733105057230848,2017-07-25 06:24:37,17,3,20,False,AAAAAAAAAAAAHHHHHHHHHHHHHHHH,28
646,889731996968210433,2017-07-25 06:20:13,1,0,1,True,@dmgillis AAAAAAAAAAAAAHHHHHHHHHH,33
647,889731996913631232,2017-07-25 06:20:13,0,0,0,True,@MessyTheMeme AAAAAAAAAAAAAAAAAAAAAAAHHHHHHHHHHHHHHH,52
648,889730733534785536,2017-07-25 06:15:11,0,0,0,True,@MessyTheMeme AAHHHHHHHHHHH,27
649,889730733513859072,2017-07-25 06:15:11,0,0,0,True,@CoyoteTraveller AAAAAAAAHHHHHHHH,33
650,889730592308428800,2017-07-25 06:14:38,17,5,22,False,AAAAAAAAAAAAAAAAAAAAHHHHHHHHHHHHHHH,35
651,889729479865761792,2017-07-25 06:10:13,0,0,0,True,@MessyTheMeme AAAAAAAAAAAHHHHHHH,32
652,889729479832215552,2017-07-25 06:10:13,1,0,1,True,@dmgillis AAAAAAAAAAHHHHHHHHHHHHHHH,35
653,889728212166692864,2017-07-25 06:05:10,0,0,0,True,@MessyTheMeme AAAAAAAAAAAAAHHHHHHH,34
654,889728212141568000,2017-07-25 06:05:10,0,0,0,True,@MariaHaskins AAAAAAAAAAAHHHHHHHHHHHH,37
655,889728212141563904,2017-07-25 06:05:10,1,0,1,True,@dmgillis AAAAAAAAAAAAAAAAAH,28
656,889728073427542016,2017-07-25 06:04:37,10,3,13,False,AAAAAAAAHHHHHHHHH,17
657,889726962079543296,2017-07-25 06:00:12,0,0,0,True,@MessyTheMeme AAAAAAAAAAAAAAAHHHHHHHHHH,39
658,889725699598299137,2017-07-25 05:55:11,0,0,0,True,@MessyTheMeme AAAAAAAAAAAAAAAAHHHHHHHHHHHHHHHH,46
659,889725557117734912,2017-07-25 05:54:37,14,2,16,False,AAAAAAAAAAAAAAHHHHHHH,21
660,889724444373135361,2017-07-25 05:50:12,0,0,0,True,@MessyTheMeme AAAAAAAAAAHHHH,28
661,889723180163715072,2017-07-25 05:45:11,0,0,0,True,@MessyTheMeme AAAAAAAAAAHHHHHH,30
662,889723040346636288,2017-07-25 05:44:37,13,3,16,False,AAAAAAAAAAAAAAHHHHHHHHHHH,25
663,889721929946587136,2017-07-25 05:40:12,0,0,0,True,@MessyTheMeme AAAAAAAAAAAAAAAAAHHHHHHHHHHHHHHHH,47
664,889720662750883841,2017-07-25 05:35:10,0,0,0,True,@paintedbird AAAAAAAAAAAAAAAAAAAAAAAH,37
665,889720520744333312,2017-07-25 05:34:37,25,7,32,False,AAAAAAAAAAAAAAAAAAAAAHHHHHHHHHHHHH,34
666,889718006510694400,2017-07-25 05:24:37,18,12,30,False,AAAAAAAAAAAAAAAAAAAAAHHHHHHHHHHHHHHHH,37
667,889715488196055040,2017-07-25 05:14:37,15,2,17,False,AAAAAAAAHHHHHHHHHHHHHH,22
668,889714374906171394,2017-07-25 05:10:11,1,0,1,True,@RaSaysGo AAAAAAAAAAAAAAAAAAAAHH,32
669,889714374881026048,2017-07-25 05:10:11,0,0,0,True,@gotravelgear AAAAAAAAAAAAAAHHHHHHHHH,37
670,889713116489101312,2017-07-25 05:05:11,2,1,3,True,@ChristinLuvsSno AAAAAAAAAAAAHHHHHH,35
671,889713116308799488,2017-07-25 05:05:11,1,1,2,True,@ThrownIntoSol AAAAAAAAAAAAAAAAAAAAAHHHHHHHHHHHHHHH,51
672,889713116304506880,2017-07-25 05:05:11,0,0,0,True,@gotravelgear AAAAAAAAAAAAAAAAAAHHHHHHHHHHHH,44
673,889712974839066624,2017-07-25 05:04:37,19,5,24,False,AAAAAAAAAAAAAAAAAAAAHHHHHHHHH,29
674,889711874354417664,2017-07-25 05:00:15,1,0,1,True,@lovablemarketer AAAAAAAAAAHHHHHHHHHHHHHHH,42
675,889711874081783808,2017-07-25 05:00:15,1,0,1,True,@lovablemarketer AAAAAAAAAAAAAAAAAAH,36
676,889710596853301248,2017-07-25 04:55:10,1,0,1,True,@lovablemarketer AAAAAAAAHHHHHHHHHHHHHH,39
677,889710456696426497,2017-07-25 04:54:37,14,4,18,False,AAHHH,5
678,889709345151348737,2017-07-25 04:50:12,1,0,1,True,@lovablemarketer AAAAAAAHHHHHHHHHH,34
679,889708080010862592,2017-07-25 04:45:10,0,0,0,True,@anjili AAAAAAAAAAAAAAAAAAAAAAAH,32
680,889708080010809345,2017-07-25 04:45:10,0,0,0,True,@lovablemarketer AAAHHHHHHHH,28
681,889707937987538946,2017-07-25 04:44:37,19,9,28,False,AAAAAAAAAAAAAHHHHHHHHHHHHHH,27
682,889706831429464065,2017-07-25 04:40:13,0,0,0,True,@DianaJoy32 AAAAAHHHHHHHHHHHHHHHH,33
683,889706831425265664,2017-07-25 04:40:13,0,0,0,True,@lovablemarketer AAAAAAAAAHHHHHHHHH,35
684,889705570936262659,2017-07-25 04:35:12,0,0,0,True,@lovablemarketer AAAAAHHHH,26
685,889705424647335936,2017-07-25 04:34:37,20,7,27,False,AAAAAAHHHHHHH,13
686,889702904889835520,2017-07-25 04:24:37,13,6,19,False,AAAAAAAHHHH,11
687,889700388181610496,2017-07-25 04:14:37,12,3,15,False,AAAHHHHHHHHHHHHHHH,18
688,889697874908459008,2017-07-25 04:04:37,17,5,22,False,AAAAAAAAAAHHHHHHHHHH,20
689,889696769977831424,2017-07-25 04:00:14,1,1,2,True,@OvernightHaulin AAHHHHHHHH,27
690,889696769969467392,2017-07-25 04:00:14,0,0,0,True,@AMalik25 AAAAAAAAAAAAAAAHHHHHHHHHHHHHH,39
691,889696769872998401,2017-07-25 04:00:14,0,0,0,True,@HBernese AAAAAAAAAAAHHHHHHHH,29
692,889695354832252928,2017-07-25 03:54:36,16,9,25,False,AAAAAAAAAAHHHHHHHHHHHHHHHH,26
693,889694251407347713,2017-07-25 03:50:13,0,0,0,True,@benjamin_silver AAAAAAAAAAAAAHHHHHHHHHHHHHHHH,46
694,889692985474109441,2017-07-25 03:45:12,1,0,1,True,@sorrykb AAAAAAAAAAAAAAAAHH,27
695,889692838438604800,2017-07-25 03:44:37,20,7,27,False,AAAAAAAAAAAAAAAHHHH,19
696,889691729112297472,2017-07-25 03:40:12,0,0,0,True,@Cosette2016 AAAAAAAAAAAAAAAAAHHHHH,35
697,889690323013832704,2017-07-25 03:34:37,13,8,21,False,AAAAAAAAAAAAAAAAAAAAAAHHH,25
698,889689209921048577,2017-07-25 03:30:11,1,0,1,True,@ColleenPhelps AAAAAAAAAHHHHHHH,31
699,889687808809545728,2017-07-25 03:24:37,16,10,26,False,AAAAAAAAAAAAAAAAAAAHHHHHHH,26
700,889686696048156674,2017-07-25 03:20:12,1,1,2,True,@MeryContrery AAAAAAAAAAAHHHHHHHHHHHHH,38
701,889686696035577857,2017-07-25 03:20:12,1,0,1,True,@calagarden AAAAAAAAHHHHHHHHHH,30
702,889685433784913921,2017-07-25 03:15:11,0,0,0,True,@realb0b AAAAAAAAAAAAHHHH,25
703,889685433780711429,2017-07-25 03:15:11,1,0,1,True,@eerily_familiar AAAHH,22
704,889685433772367872,2017-07-25 03:15:11,0,0,0,False,@realb0b AAAAAAAAAAAAAAAAAAAHHHHH,33
705,889685290109030401,2017-07-25 03:14:37,47,19,66,False,AAAAAAAAAAAAAAAAAAAAAAAHHHHHHHHHHHHH,36
706,889684180287750144,2017-07-25 03:10:12,0,0,0,True,@NvrRyan AAAAAAAAAAAAAAAAAAAAAAAHHHHHHHHHH,42
707,889684180237463552,2017-07-25 03:10:12,0,0,0,True,"@realb0b AAAAAAAAAAAAAAAAAAAHHHHHHHHHHH 
https://t.co/aofN6lUDJJ",64
708,889684180162007044,2017-07-25 03:10:12,0,0,0,True,@realb0b AAAAAAAAAAAAHHH,24
709,889684180149432320,2017-07-25 03:10:12,0,0,0,True,@SonicBananas87 AAAAAAAAAAH,27
710,889684180120031232,2017-07-25 03:10:12,3,1,4,True,@Aprillia AAAAH,15
711,889684180099051520,2017-07-25 03:10:12,0,0,0,True,@NvrRyan AAAAAAAAAAAAHHHHHHHH,29
712,889682919173890048,2017-07-25 03:05:12,0,0,0,False,@realb0b AAAAAAAHHHHHHHHHHHH,28
713,889682919110914050,2017-07-25 03:05:12,0,0,0,True,@LVFREW AAAAAAAAAAAAAAHHHHHHH,29
714,889682919106719744,2017-07-25 03:05:12,0,0,0,True,@NvrRyan AAAAAAAAAAAAAHHHHHHHHHH,32
715,889682773392404481,2017-07-25 03:04:37,13,3,16,False,AAAAAAAAAAAHHHHH,16
716,889681665605464064,2017-07-25 03:00:13,0,0,0,True,@l_vijay AAAAAAAAAAAHHHHHHHHH,29
717,889681665567711234,2017-07-25 03:00:13,0,0,0,True,@realb0b AAAAAAAAHHHHHHHHHHH,28
718,889681665538260992,2017-07-25 03:00:13,0,0,0,True,@tz1969 AAAAAAAAAAAAAAAAAAAAAHHHHHHHHHHHHHHH,44
719,889681665529978881,2017-07-25 03:00:13,0,0,0,True,@whereIsTheSpai AAAAAAAAAAAAAAHHHHHHHHHHHH,42
720,889680403082162177,2017-07-25 02:55:12,0,0,0,True,@rimaanabtawi AAAAAAHHHHHHHHHHHHH,33
721,889680403065450497,2017-07-25 02:55:12,0,0,0,True,@debpolst AAAAAAAHHHHHHH,24
722,889680403057061892,2017-07-25 02:55:12,0,0,0,True,@IDisposable AAAAAAAAAAAAAAAHHHHHHHHHHHHHHH,43
723,889680403040284673,2017-07-25 02:55:12,0,0,0,True,@ClimateAudit AAAAAAAAAAAAAAAAAAAAAAAHHHHHHHHHHHHHH,51
724,889680403040276480,2017-07-25 02:55:12,0,0,0,True,@DerekTodorojo AAAAAAAAAAAHHHHHHHHHH,36
725,889680403031887873,2017-07-25 02:55:12,0,0,0,True,@RighteousBabe4 AAAAAAAAHHHHHH,30
726,889680254817710084,2017-07-25 02:54:36,21,6,27,False,AAAAAAAAAAAAAAAAAAAAHHHHHHHH,28
727,889679142068858881,2017-07-25 02:50:11,1,0,1,True,@becpump32 AAHHHHHHHHHHHH,25
728,889679142018580485,2017-07-25 02:50:11,0,0,0,True,@ChristieXOJxhn AAAAAAAAAHHH,28
729,889679141968195584,2017-07-25 02:50:11,0,0,0,True,@ChristieXOJxhn AAAAAAAAAHHHHHHHHHHHHHHH,40
730,889679141964058624,2017-07-25 02:50:11,0,0,0,True,@Laura8448 AAAAAAAAAAAAAAAAAAAAHHHHHH,37
731,889679141964050432,2017-07-25 02:50:11,0,0,0,True,@musgrove_david AAAAAAAAAAAHHHHHHHH,35
732,889679141963956224,2017-07-25 02:50:11,1,0,1,True,@the36review AAAAAAAAAAAAAAAHHHHHHHHHHHHHH,42
733,889679141959860224,2017-07-25 02:50:11,7,1,8,True,@TMctrumpyface AAAAHHHHHHHHHHHH,31
734,889677886516547585,2017-07-25 02:45:12,37,3,40,True,"@pwnallthethings AAAAAAAAAHHHH 
https://t.co/GjpsuOA9j0",55
735,889677886508105732,2017-07-25 02:45:12,0,0,0,True,@ClimateAudit AAAAAAAAHHHHHHHHHH,32
736,889677886495608832,2017-07-25 02:45:12,21,0,21,True,@DisgracedSpicey AAHHH,22
737,889677742677143557,2017-07-25 02:44:37,67,37,104,False,AAAAAAAAAAAAAAAAHHHHHHHHHHHHHH,30
738,889676637155012608,2017-07-25 02:40:14,0,0,0,True,@UNrealTara AAAAAAAAAAAAAAAAAAAHHHHHHHHHHHH,43
739,889676637150863361,2017-07-25 02:40:14,9,0,9,True,@suzanne_cummins AAHHHHHHHHH,28
740,889676637092098048,2017-07-25 02:40:14,1,0,1,True,@Cpo10za AAAAAAAAAAAAHHHHHHHHHHHHHHH,36
741,889676637087956992,2017-07-25 02:40:14,0,0,0,True,@NvrRyan AAAAAAAAAAAAAAHHHHHHHHHHHH,35
742,889676636970418176,2017-07-25 02:40:14,0,0,0,True,@Bangelnuts AAAAAAAAH,21
743,889675370068406273,2017-07-25 02:35:12,0,0,0,True,@karen0928 AAAAAAAAAAAAHHHHH,28
744,889675370030661632,2017-07-25 02:35:12,21,0,21,True,@QueenBe74182030 AAAHHHHHHHHHHH,31
745,889675369992912896,2017-07-25 02:35:12,4,0,4,True,"@DrIllusion AAAAAAHHHHHHHHHH 
https://t.co/h23hgBJBeD",53
746,889675369988718592,2017-07-25 02:35:12,0,0,0,True,@scudworx AAAAAAAAAAAAAAAAAAHHHHHHHHHHHH,40
747,889675224656039937,2017-07-25 02:34:37,22,14,36,False,AAAAAAAAAAAAAAAAAAHHHHHHHHHHHHHH,32
748,889674114021150721,2017-07-25 02:30:12,0,0,0,True,@robertdolliver AAAAAAAAHHHHHHHHH,33
749,889674114012778496,2017-07-25 02:30:12,0,0,0,True,@ewmda AAAAAAAAAAAAAAAAAAHHHHHH,31
750,889674114004381697,2017-07-25 02:30:12,15,2,17,True,@pwnallthethings AAAAAAAAAAAAAAAAAAAAAAHHHHHHHHHHHHHHHH,55
751,889672704957325312,2017-07-25 02:24:36,21,7,28,False,AAAAAAAAAAAAAAAHHHHH,20
752,889670337352404992,2017-07-25 02:15:12,0,0,0,True,@ZyxSync AAAAAAAAAAAHHH,23
753,889670190862127104,2017-07-25 02:14:37,12,3,15,False,AAAAAAAAHHHHHHHHHHH,19
754,889667676385271808,2017-07-25 02:04:37,10,1,11,False,AAAHHHHHHHHHH,13
755,889665156300591104,2017-07-25 01:54:37,12,5,17,False,AAH,3
756,889662639877611520,2017-07-25 01:44:37,14,8,22,False,AAAAAAAAAAAAAAAAAAAAAHHHHHHHHHHHHHH,35
757,889660125795016708,2017-07-25 01:34:37,9,8,17,False,AAAAAAAAAAAAHHHHHHH,19
758,889657609325862913,2017-07-25 01:24:37,9,3,12,False,AAAAAAAAAAAAAHHHHHHHHHHHHHHHH,29
759,889655092902756354,2017-07-25 01:14:37,6,6,12,False,AAAAAAAHHHHHHHHHHHHH,20
760,889653983266131970,2017-07-25 01:10:13,0,0,0,True,@davidb813 AAAAAAAAAAAAAAHHHHHHHHHH,35
761,889652579105468416,2017-07-25 01:04:38,11,3,14,False,AAAAAAAAAAAAAAAAAHHH,20
762,889650245721882625,2017-07-25 00:55:22,0,0,0,True,@StirCalifornia AAAAAAAAAAAAAAAAAHHHHHHHHHH,43
763,889650061076033536,2017-07-25 00:54:38,6,6,12,False,AAAAAHHHHH,10
764,889647539905077252,2017-07-25 00:44:37,9,5,14,False,AAAAAAAAAAAAAAAAAAHHHHHHHHHHHHH,31
765,889645026158030849,2017-07-25 00:34:37,5,2,7,False,AAHHHHHHHHHHHHHHH,17
766,889642509797912576,2017-07-25 00:24:37,18,10,28,False,AAAAAAAAAAHHHHHHHHHHHHHH,24
767,889640132441198598,2017-07-25 00:15:10,0,0,0,True,@DrLRHartMD AAAAAAAAAAAAAAAAAAAAAHHHH,37
768,889639992640888832,2017-07-25 00:14:37,5,0,5,False,AAAAAAAAAAAAAAAHH,17
769,889638884824539138,2017-07-25 00:10:13,0,0,0,True,@maikofigur AAAAAAAAAAAAAAAAAAHHHHHHHHHHHHHHH,45
770,889637619667173378,2017-07-25 00:05:11,1,0,1,True,@StirCalifornia AAAAAAAAAAAAAAAAAAAAHHHHHHHHHHHHHHHH,52
771,889637474594684929,2017-07-25 00:04:37,5,2,7,False,AAAAAAAAAAHH,12
772,889634957882261504,2017-07-24 23:54:37,13,12,25,False,AAAAAAAAAAAAAAAAAAAHHHHHH,25
773,889632440393793539,2017-07-24 23:44:37,4,2,6,False,AAAAAAAHHHHHHHHH,16
774,889629924813930498,2017-07-24 23:34:37,8,3,11,False,AAAAAAAHHHH,11
775,889627408009232385,2017-07-24 23:24:37,33,19,52,False,AAAAAHHHHHHHHHHH,16
776,889624891800137729,2017-07-24 23:14:37,5,3,8,False,AAAAAAAAAAAHHHHHHHH,19
777,889622377046433792,2017-07-24 23:04:37,4,2,6,False,AAAAAAAAAAHHHHH,15
778,889619858534608896,2017-07-24 22:54:37,11,0,11,False,"AAAAAAAAHHHHHH 
https://t.co/yV4Viu5hXX",39
779,889617341276966913,2017-07-24 22:44:37,9,3,12,False,AAAAAAAAAAAAAAAAAAAAAHHHHHHHH,29
780,889616232646881280,2017-07-24 22:40:12,0,0,0,True,@Edgardo_PhD AAAAAAAAAAHHHHHHHHH,32
781,889614826787483648,2017-07-24 22:34:37,10,3,13,False,AAAAAAAAAAAAAAAAAAH,19
782,889612308598722560,2017-07-24 22:24:37,14,9,23,False,AAAAAAAAAAAAAAAAAAAAHHHHHHHHHHH,31
783,889609792574062593,2017-07-24 22:14:37,5,4,9,False,AHHHHHHHHHH,11
784,889607278403256320,2017-07-24 22:04:37,7,4,11,False,AAAAAAAAAAAAHHHHHHHHHHHHHHH,27
785,889604760025935872,2017-07-24 21:54:37,11,6,17,False,AAAAAAAAAAAAAHH,15
786,889602385605263361,2017-07-24 21:45:11,0,0,0,True,@chick_in_kiev AAAAAAAAAAAAHH,29
787,889602240989868032,2017-07-24 21:44:36,4,2,6,False,AAAAHHHHHHHHHHHH,16
788,889599726089383937,2017-07-24 21:34:37,9,0,9,False,AAAAAAAAAAAAAAAAAAAAAHHHHHHH,28
789,889597356454404097,2017-07-24 21:25:12,0,0,0,True,@lovablemarketer AAAAAAAAAAAAAAAAAHHHHHHHHHHH,45
790,889597356433432576,2017-07-24 21:25:12,1,0,1,True,@StirCalifornia AAAAAAAAAAAAAAAAAAAAAHHHHHHHHH,46
791,889597210761072644,2017-07-24 21:24:37,16,8,24,False,AAAAAAAAAAAAHHHHH,17
792,889596097173348356,2017-07-24 21:20:12,0,0,0,True,@defectiveMom AAAAAAAHHH,24
793,889594694455480326,2017-07-24 21:14:37,21,7,28,False,AAAAAAAAAAAAAAAAAAAAAAHHHHHHHHH,31
794,889593580737753094,2017-07-24 21:10:12,0,0,0,True,@Dragon_DLV AAAAAAAAAAAAHHHHHHHHHHHHHH,38
795,889592319447625728,2017-07-24 21:05:11,0,0,0,True,@OlNaved AAHHHHHHHHHHHH,23
796,889592176350552064,2017-07-24 21:04:37,15,9,24,False,AAAAAAAAAAAAAAAAHHHHHHHHH,25
797,889591071101026304,2017-07-24 21:00:13,0,0,0,True,@OlNaved AHHHHHH,16
798,889589802319962112,2017-07-24 20:55:11,0,0,0,True,@OlNaved AAAAAAAAAAAAAAAAHHHHHHH,32
799,889589662125363200,2017-07-24 20:54:37,19,15,34,False,AAAAAAAAAAAAAAAAAAAAAAHHHHHHH,29
800,889587145467469824,2017-07-24 20:44:37,9,1,10,False,AHHHHHHHHHHHHHH,15
801,889584627622531072,2017-07-24 20:34:37,21,5,26,False,AAAAAAAAAAAAAAAAAAAAAAHHHHHH,28
802,889582110146797571,2017-07-24 20:24:37,6,3,9,False,AAHHHHHHHHH,11
803,889579592192847872,2017-07-24 20:14:37,2,2,4,False,AAAAAAHHHH,10
804,889577077300764672,2017-07-24 20:04:37,17,6,23,False,AAAAAAAAAAAAAAAAHHHHHHHHHHHHHHH,31
805,889574561926324224,2017-07-24 19:54:37,7,3,10,False,AAAAAAAAAAAAAAAAAAAHHHH,23
806,889572041879412737,2017-07-24 19:44:36,9,4,13,False,AAAAAAAAAAAAAAAAAAAAAAAHHH,26
807,889569528908218369,2017-07-24 19:34:37,6,3,9,False,AHHHHHH,7
808,889567010178441216,2017-07-24 19:24:37,9,0,9,False,AAAAAAAAAAAAAAAAHHHHHHHHHHH,27
809,889565903372865538,2017-07-24 19:20:13,4,0,4,True,@delrayser AAAAAAAAAAAAAAAAHHHHHHHHHH,37
810,889564493038178304,2017-07-24 19:14:37,9,3,12,False,AAAAAAAAAHHHHHHHHHHHH,21
811,889561977445654528,2017-07-24 19:04:37,9,0,9,False,AAAAAAAAAAAAAAAAAHH,19
812,889559462985510912,2017-07-24 18:54:37,6,0,6,False,AAAHHHH,7
813,889556943781625856,2017-07-24 18:44:37,9,1,10,False,AAAAAAAAAAAAAAHHHH,18
814,889555832140165120,2017-07-24 18:40:12,0,0,0,True,@Torschy AAAAAAAAAAAAAAHHHHHHHHHHHHH,36
815,889554428512133121,2017-07-24 18:34:37,11,5,16,False,AAAAAAHHHHHHHHHHHHHH,20
816,889551912042934272,2017-07-24 18:24:37,6,3,9,False,AAAAAAAHHHHHHHH,15
817,889550802154528768,2017-07-24 18:20:12,0,0,0,True,@11c6558cc63241f AAAAAAAAAAHH,29
818,889550801978392576,2017-07-24 18:20:12,0,0,0,True,@tm_roy AAAAAAAAAAAAAHHHHHH,27
819,889550801974296576,2017-07-24 18:20:12,0,0,0,True,@Sihayanami AAAAAAAAAAAAHHHHHHHH,32
820,889549395355738113,2017-07-24 18:14:37,9,5,14,False,AAAAAAAAAAHHHHHHHHHHHH,22
821,889548284104232962,2017-07-24 18:10:12,0,0,0,True,@HCCavall AAAAAAAAAAAAAAHHHHHHHHHHHHHH,38
822,889547019848749057,2017-07-24 18:05:11,0,0,0,True,@LeeBlogger5 AAAAAAAAAAAAAAAAAAAHHHH,36
823,889547019844546561,2017-07-24 18:05:11,0,0,0,True,@HCCavall AAAAAAAAAAAHHHHH,26
824,889546878483931137,2017-07-24 18:04:37,5,2,7,False,AAAAHHHH,8
825,889544361846984707,2017-07-24 17:54:37,6,0,6,False,AAAAAAAH,8
826,889541843658125312,2017-07-24 17:44:37,2,0,2,False,AAAHHHHHHHHH,12
827,889539329009344513,2017-07-24 17:34:37,7,3,10,False,AAAAAAAAAAAAAAAHHHHHHHHHH,25
828,889536954278092800,2017-07-24 17:25:11,0,0,0,True,@lovablemarketer AAAAAAAAAAAAAAAAAAAAAAAHHHH,44
829,889536812611489793,2017-07-24 17:24:37,6,1,7,False,AAAAAAAAAAAAAHHHHH,18
830,889534296448544770,2017-07-24 17:14:37,8,7,15,False,AAAAAAAAAAAAAAAAAAAHHHHHHHHHHHHHH,33
831,889531779132141576,2017-07-24 17:04:37,9,4,13,False,AAAAAAAAAAAAAAAAAAAAAHHHHHHHHHHHH,33
832,889529262897860608,2017-07-24 16:54:37,11,2,13,False,AAAAAAAAAAAAAAAAAAAAAAAH,24
833,889526746550341632,2017-07-24 16:44:37,12,4,16,False,AAAAAAAAAAAAAAAAAAAAAAHHHHHHHHHHHHHHH,37
834,889524228831277056,2017-07-24 16:34:37,11,1,12,False,AAAAAAAAAAAAAAHHHHHHHH,22
835,889521713591066625,2017-07-24 16:24:37,6,0,6,False,AAAAAAAAAAAHH,13
836,889519193820975104,2017-07-24 16:14:36,8,2,10,False,AAAAAAAAAAAAAAHHH,17
837,889516681420255232,2017-07-24 16:04:37,13,5,18,False,AAAAAAAAAAAAAAAHHHHHHHHHHHHH,28
838,889514161373368320,2017-07-24 15:54:37,16,7,23,False,AAAAAAAAAAAAAAAAAAHHHHH,23
839,889511647815106560,2017-07-24 15:44:37,14,2,16,False,AAAAAAAAAHHHHH,14
840,889509127910813696,2017-07-24 15:34:37,9,2,11,False,AAAAAAAAAAAHHHH,15
841,889506611949166597,2017-07-24 15:24:37,7,0,7,False,AAAHHHHHHH,10
842,889504095417106433,2017-07-24 15:14:37,10,2,12,False,AAAAHHH,7
843,889501579988041728,2017-07-24 15:04:37,16,8,24,False,AAAAAAAAAAAAAAAAHHHHHHHHHHH,27
844,889499065112813569,2017-07-24 14:54:37,17,10,27,False,AAAAAAAAAAAAAAAAAAAHHHHHHHHHHHHHHHH,35
845,889497953584513025,2017-07-24 14:50:12,2,1,3,True,@ExiledCaste AAAAAAAAAAAAAAAAAAAAAAAHHHHH,41
846,889496546257104896,2017-07-24 14:44:37,13,7,20,False,AAAAAAAAAAAAAAAAAAAAAAAHHHHHHHHHHHHHHHH,39
847,889494174134829056,2017-07-24 14:35:11,0,0,0,True,@KHmarvel121 AAAAAAAAAAAAAAAAAAHHHHHHHHHHH,42
848,889494031700512768,2017-07-24 14:34:37,8,0,8,False,AAAAAAAAAAH,11
849,889491512685469696,2017-07-24 14:24:37,7,8,15,False,AAAAAAAAAAAAAAAAAAAAHHHHHHHHHHHHH,33
850,889488997994684416,2017-07-24 14:14:37,6,0,6,False,AAAAAAAHH,9
851,889486481236123648,2017-07-24 14:04:37,6,3,9,False,AAAAAAAAAAHHHHHHHHHHHHH,23
852,889483964892807168,2017-07-24 13:54:37,7,0,7,False,AAAAAAAAAAAAAAAHHHHHHHH,23
853,889481447815487489,2017-07-24 13:44:37,9,2,11,False,AAAAAAAAAAAAAAAAAAAAAAHHHH,26
854,889478932218732544,2017-07-24 13:34:37,10,3,13,False,AAAAAAAAAAAAAAAAAAAAAHHHHHHHHHH,31
855,889476557542174721,2017-07-24 13:25:11,1,0,1,True,@nickitweety82 AH,17
856,889476413778165760,2017-07-24 13:24:37,11,4,15,False,AAAAAAAAAAAAAAHHHHHHHHHHH,25
857,889473896302489600,2017-07-24 13:14:37,5,1,6,False,AAAAAAAHHHHHHHHHHHHHHHH,23
858,889471382102437888,2017-07-24 13:04:37,7,7,14,False,AAAAAAHHHHHHHHHHHHHHH,21
859,889468864131719168,2017-07-24 12:54:37,8,3,11,False,AAAAAAAAAAAHHHHHHHHHHH,22
860,889466350015590400,2017-07-24 12:44:37,7,4,11,False,AAAAAAAAAAAAAAAAAAAH,20
861,889465245701459969,2017-07-24 12:40:14,0,1,1,True,@mariecarnes AAAAAAAAAAAAAAAAAAAHHHHHHHHHH,42
862,889463831876993024,2017-07-24 12:34:37,3,3,6,False,AAAAAAAAAAAAAHHHHHHHHHHHHH,26
863,889461314615115776,2017-07-24 12:24:37,5,2,7,False,AAAAAAAAAAHHHHHHHHHHHHHHHH,26
864,889458797684674560,2017-07-24 12:14:37,4,1,5,False,AAAAAAHHH,9
865,889456281798488064,2017-07-24 12:04:37,2,2,4,False,AAAAAHH,7
866,889453764855439362,2017-07-24 11:54:37,9,9,18,False,AAAAAAAAHHHHHHHHH,17
867,889451249720066049,2017-07-24 11:44:37,5,2,7,False,AAAAAAAAHHHHHHHHHH,18
868,889448732932091906,2017-07-24 11:34:37,14,10,24,False,AAAAAAAAAAAAAAHHHHHHHHHHHHHHHH,30
869,889446217570291712,2017-07-24 11:24:38,7,2,9,False,"AAAAAAAAAAAAAAAAAAHHHHHHHH 
https://t.co/cJJofLJO7W",51
870,889443699788328960,2017-07-24 11:14:37,6,0,6,False,AAAAHH,6
871,889441181704347648,2017-07-24 11:04:37,9,3,12,False,AAAAAAAAAAAAHHHHHH,18
872,889438665256177664,2017-07-24 10:54:37,1,2,3,False,AAAAAAAAAAAAHHHHHHHH,20
873,889436148510187520,2017-07-24 10:44:37,5,3,8,False,AHHHHHHHHHHH,12
874,889433629876789248,2017-07-24 10:34:36,7,8,15,False,AAAAAAAAAAAAHHHHHHHHHHHHHHH,27
875,889431114309406720,2017-07-24 10:24:37,9,7,16,False,AAAAAAAAAAAAAAAAAAAAAHHHHHHHHHHHHHH,35
876,889428601065668608,2017-07-24 10:14:37,3,0,3,False,AAAAAAAAHH,10
877,889426083501809665,2017-07-24 10:04:37,2,1,3,False,AAAAAAAAAAAAAAAAAAAHHH,22
878,889423564042108928,2017-07-24 09:54:37,2,3,5,False,AAAAAAAAAAAAAAAAAHHHHHHH,24
879,889421051515609088,2017-07-24 09:44:37,8,4,12,False,AAAAAAAAAAAAAAAAAAAAHHHHHHHHHH,30
880,889418532798287872,2017-07-24 09:34:37,2,0,2,False,AHH,3
881,889416017062932480,2017-07-24 09:24:37,1,4,5,False,AAAAAAAAAAAAAAAAAAAAAHHHHHHHHH,30
882,889413497469251585,2017-07-24 09:14:36,2,1,3,False,AAAAAAAHHHHHHHHHHHH,19
883,889410985026629633,2017-07-24 09:04:37,1,5,6,False,AAAAAAAAAAAAAAAAHHHHHHHH,24
884,889408465894072320,2017-07-24 08:54:37,2,1,3,False,AAAAAHHHHHHHHHH,15
885,889405951496859648,2017-07-24 08:44:37,3,3,6,False,AAAAAAAAAAAAAAAAAAAAAAHHHHH,27
886,889403433039663107,2017-07-24 08:34:37,1,1,2,False,AAAAAAAAAAAAAAAH,16
887,889400915073040384,2017-07-24 08:24:37,4,5,9,False,AAAAAAAAAAAAAAAAAAAAAH,22
888,889398401342812160,2017-07-24 08:14:37,2,6,8,False,AAAAAAAAAAAAAAAHHHHHHHHH,24
889,889395883753844736,2017-07-24 08:04:37,3,5,8,False,AAAAAAAAAAAAAHHHHHHHHHHHH,25
890,889393367263703040,2017-07-24 07:54:37,4,2,6,False,AAAAAAHHHHHHHH,14
891,889390849611706368,2017-07-24 07:44:37,7,3,10,False,AAHHHHHH,8
892,889388335097147392,2017-07-24 07:34:37,8,6,14,False,AAAAAAAAAAAAAAAHHHHHHHHHHHHHHH,30
893,889385818216857601,2017-07-24 07:24:37,7,7,14,False,AAAHHHHHHHH,11
894,889383301932355585,2017-07-24 07:14:37,6,2,8,False,AAAAAAAAAAAAAAAHHHH,19
895,889380783470899200,2017-07-24 07:04:37,10,3,13,False,AAAAAAHHHHHHHHHHHH,18
896,889378268775931909,2017-07-24 06:54:37,6,3,9,False,AAAAAAAAAAAAAHHHHHHHHHH,23
897,889375750348050432,2017-07-24 06:44:37,4,2,6,False,AAAAAAAAAAAHHHHH,16
898,889373232826130433,2017-07-24 06:34:37,9,3,12,False,AAAAAAAAAAAAAAAAAAHHHHHHHHH,27
899,889370718563127297,2017-07-24 06:24:37,7,6,13,False,AAAAAAAAAAAAAAAAAAAAHHHHHHHHHHHHHH,34
900,889368343714680836,2017-07-24 06:15:11,0,0,0,True,@Moogboy808 AAAAAAAAAAHHHHHHHHH,31
901,889368200126889984,2017-07-24 06:14:37,9,2,11,False,AAAHHHHHH,9
902,889365683611500544,2017-07-24 06:04:37,5,3,8,False,AAAAHHHHHHHHHHH,15
903,889363167800950784,2017-07-24 05:54:37,6,3,9,False,AAAAAAAAAHHHHHHHHH,18
904,889360648936849408,2017-07-24 05:44:36,5,2,7,False,AAAAAAAAAAAAHHHH,16
905,889359535550472192,2017-07-24 05:40:11,0,0,0,True,@DennisYowYow AAAAAAAAAAAAAAAAAAAAAAHHHHHHHHHHHHHHH,51
906,889358135084933121,2017-07-24 05:34:37,11,5,16,False,AAAAAAAAAAAAAAAAAAHHHH,22
907,889355616212463617,2017-07-24 05:24:36,17,13,30,False,AAAAAAAAAAAAAAAAAAHHHHHHHHHHHHHHHH,34
908,889353103019061248,2017-07-24 05:14:37,5,2,7,False,AAHHHHHHHHHHHHHH,16
909,889350586201776128,2017-07-24 05:04:37,8,6,14,False,AAAAAAAAHHHHHHHHHHHHH,21
910,889348067417350145,2017-07-24 04:54:37,11,4,15,False,AAAAAAAAAAAAAAAAAAAAAHHHHHHH,28
911,889345693005099008,2017-07-24 04:45:11,0,0,0,True,@Basinke AAAAAAAAAAAAHH,23
912,889345552256827392,2017-07-24 04:44:37,11,4,15,False,AHHHHHHHHHHHHHHHH,17
913,889343034730717184,2017-07-24 04:34:37,6,4,10,False,AAAAAAAAAAAAAHHHH,17
914,889340516227321860,2017-07-24 04:24:36,14,5,19,False,AAAAAAAAAAAAHHHHHHHHHHHHHH,26
915,889338001695879168,2017-07-24 04:14:37,11,7,18,False,AAAAAAAAAAAHHHHHHHHHHHHHHHH,27
916,889335487449714688,2017-07-24 04:04:37,13,7,20,False,AAAAAAAAAAAAHHHHHHHHHH,22
917,889332967214067714,2017-07-24 03:54:37,12,6,18,False,AAAAAAAAAAAAAAHHHHHHHHHHHHHHHH,30
918,889330451650924546,2017-07-24 03:44:37,8,1,9,False,AAAAHHHHHHHH,12
919,889327935475380224,2017-07-24 03:34:37,22,11,33,False,AAAAAAAAAAAAAHHHHHHHHHHHH,25
920,889325428925771776,2017-07-24 03:24:39,15,3,18,False,AAAAAAAAAAHHHHHHHHHHHH,22
921,889322909562548225,2017-07-24 03:14:39,14,5,19,False,AAAAAAAAAAAAAAAAAAAHHHHHHH,26
922,889320392787197953,2017-07-24 03:04:39,15,9,24,False,AAAAAAAAAAAAAAAAAAAHHHH,23
923,889317878452940801,2017-07-24 02:54:39,7,1,8,False,AAAAAAAAAAAHHH,14
924,889315358846443520,2017-07-24 02:44:38,9,5,14,False,AAAAAAHHHHHHHHHHHHHH,20
925,889312845489467392,2017-07-24 02:34:39,10,4,14,False,AAAAAHHHHH,10
926,889310328667996160,2017-07-24 02:24:39,10,3,13,False,AHHHHHHHHHH,11
927,889307809862623232,2017-07-24 02:14:39,15,6,21,False,AAAAAAAAAAAAAAAHHHHHH,21
928,889305294416859136,2017-07-24 02:04:39,9,1,10,False,AAHHHHH,7
929,889302777830285312,2017-07-24 01:54:39,12,5,17,False,AAAAAAAAAAAAAHHHHHHHHHHHHHHHH,29
930,889300259880546306,2017-07-24 01:44:39,11,0,11,False,AAAH,4
931,889297743436447744,2017-07-24 01:34:39,13,5,18,False,AAHHHHHHHHH,11
932,889295228561129473,2017-07-24 01:24:39,14,6,20,False,AAAAAAAAAAAAAAAAAAHHHHHHH,25
933,889292827586437123,2017-07-24 01:15:07,9,2,11,False,AAAAAHHHHHHHHH,14
934,889290195060887553,2017-07-24 01:04:39,13,3,16,False,AAAAAAAAAAAAAAAAAAAAAAHHH,25
935,889287680965701632,2017-07-24 00:54:39,9,1,10,False,AAAAAAAAAAAHHHH,15
936,889285164198711297,2017-07-24 00:44:39,19,6,25,False,AAAAAAAAAAAAAAHHHHHHHHHHHHHHH,29
937,889282643816312836,2017-07-24 00:34:39,22,9,31,False,AAAAAAAAAAAAAAAAAAHHHHHHHHHHHHHH,32
938,889280128173453316,2017-07-24 00:24:39,10,1,11,False,AAAAAAAHHHHHHHHH,16
939,889277609875562496,2017-07-24 00:14:38,16,4,20,False,AAAAAAAAAAAAHHHHHHHHH,21
940,889275095339982848,2017-07-24 00:04:39,16,3,19,False,AAAAAAAAAAAAAAAAAAAAAAAHHHH,27
941,889272578774368258,2017-07-23 23:54:39,14,4,18,False,AAAAAAAAAAAAAHHHHHHH,20
942,889270063915827200,2017-07-23 23:44:39,22,3,25,False,AAAAAAAAAAAAAAHHHHHHHHHHHHHH,28
943,889267546926583808,2017-07-23 23:34:39,8,3,11,False,AHHHHHHHHHHH,12
944,889265029190758400,2017-07-23 23:24:39,11,4,15,False,AAAAAAAAAAAAAAAAAAHH,20
945,889262510762840065,2017-07-23 23:14:38,16,8,24,False,AAAAAAAAAAAAAAAHHHHHHHHHHHHHHHH,31
946,889259995958824960,2017-07-23 23:04:39,9,3,12,False,AAAAAAAAAAAAHHHHHHHHHHH,23
947,889257479200223232,2017-07-23 22:54:39,13,6,19,False,AAAAAAAAAAAAAAHHHHHHHHHHHH,26
948,889254963951656960,2017-07-23 22:44:39,10,1,11,False,"AAAAAAAAAAAAAAAAAAAAAAAHHHHHH 
https://t.co/aofN6lUDJJ",54
949,889252446857572353,2017-07-23 22:34:39,14,3,17,False,AAAAAAAAAAAAAAAHHHHHHHH,23
950,889249928291258373,2017-07-23 22:24:39,13,6,19,False,AAAAAAAAAAAAAAAAAHHHHHHHHHH,27
951,889247414883934209,2017-07-23 22:14:39,20,7,27,False,AAAAAAAAAAAAAAAAAHHHHHHHHHHHHH,30
952,889244898301534213,2017-07-23 22:04:39,9,2,11,False,AAAHHHHHHHHHHHHHH,17
953,889242382922919939,2017-07-23 21:54:40,17,8,25,False,AAAAAAAAAAAAAAAAAAAAAAAHHHHHHH,30
954,889239862523695106,2017-07-23 21:44:39,20,4,24,False,AAAAAAAAAAAAAAAAAAAAAAHH,24
955,889237345660272641,2017-07-23 21:34:39,10,2,12,False,AAAHHHHHHHHH,12
956,889234829702725632,2017-07-23 21:24:39,13,3,16,False,AAAAAAAAAAAAAAHHHHHHHHH,23
957,889232312013115392,2017-07-23 21:14:38,11,3,14,False,AAAAHHHHHHHHHHHHHHH,19
958,889229799113281538,2017-07-23 21:04:39,10,1,11,False,AAAHHHHHHH,10
959,889227280903544832,2017-07-23 20:54:39,18,11,29,False,AAAAAAAAAAAAAAAAAAHHHHHHHHHHHHH,31
960,889226159354990593,2017-07-23 20:50:12,0,0,0,True,@danpeppe AAAAAAAAAAAAAAAAAAAAAAHHHHHHHHHHHHHHHH,48
961,889224762291081217,2017-07-23 20:44:38,9,2,11,False,AAAAAAAAHHHHH,13
962,889222249349341184,2017-07-23 20:34:39,10,5,15,False,AAAAAAAAAAAAAAAAAAAAHH,22
963,889219729617027073,2017-07-23 20:24:39,20,9,29,False,AAAAAAAAAAAAAAAAAHHHHHHHHHHHHHHH,32
964,889217212762001409,2017-07-23 20:14:39,11,5,16,False,AAAAHHHHHHHHHHHHHH,18
965,889214698637451267,2017-07-23 20:04:39,12,5,17,False,AAAAAAAAAAAAAAAHHHHHHH,22
966,889212179194490880,2017-07-23 19:54:38,8,1,9,False,AAHHHHHHHHHHHHH,15
967,889209666055675905,2017-07-23 19:44:39,13,1,14,False,AAAAAAAAAHHHHHHHHHHHH,21
968,889207149527740416,2017-07-23 19:34:39,11,2,13,False,AAAAAAAAAAHHHH,14
969,889204629761904641,2017-07-23 19:24:39,13,3,16,False,AAAAAAAAAHHHHHHHHHH,19
970,889202116056756224,2017-07-23 19:14:39,8,1,9,False,AAAAAAAHHHHHH,13
971,889199597914075136,2017-07-23 19:04:39,9,1,10,False,AAAAAAHHHHHHH,13
972,889198499388170243,2017-07-23 19:00:17,0,0,0,True,@BautistaBomb AAAHHHHHHH,24
973,889197216086335488,2017-07-23 18:55:11,0,0,0,True,@TedRiich AAAAAAAAAAAAAAHHHHH,29
974,889197084330659840,2017-07-23 18:54:40,6,0,6,False,AAAHH,5
975,889194565349015552,2017-07-23 18:44:39,16,6,22,False,AAAAAAAAAAAAAAHHHHHHHHHH,24
976,889192047722323973,2017-07-23 18:34:39,13,4,17,False,AAAAAAAAHHHHHHHHHHHH,20
977,889189532054294528,2017-07-23 18:24:39,8,0,8,False,AAAAAAAAAHHHHHHHHHHHHHHH,24
978,889187016554008577,2017-07-23 18:14:39,7,1,8,False,AAAAAAAHHHHHHHHHHHHHHHH,23
979,889184499879292928,2017-07-23 18:04:39,5,4,9,False,AAAAAAAHHHHHHHH,15
980,889181980197355520,2017-07-23 17:54:38,11,0,11,False,AAAAAAAAAAAAAHHHHHH,19
981,889179463912747009,2017-07-23 17:44:39,12,4,16,False,AAAAAAAAAAAAAAAAAAAHHHHHHHH,27
982,889176948257288193,2017-07-23 17:34:39,13,0,13,False,AAAAAAAAAAAAAAAHHHHHHHHHHH,26
983,889174431742005248,2017-07-23 17:24:39,8,0,8,False,AAAAAAAAAAAAAHHHHHHHHH,22
984,889171915268554753,2017-07-23 17:14:39,6,0,6,False,AAAAAHHHHH,10
985,889169398027694080,2017-07-23 17:04:39,8,1,9,False,AAAAHHHHHHH,11
986,889167015914688512,2017-07-23 16:55:11,1,0,1,True,@durindal AAAAAAAAAAHHHHHHHHHHHHHHHH,36
987,889166881424363521,2017-07-23 16:54:39,18,5,23,False,AAAAAAAAAAAAAAAAHHHHHHHHHHHHHHHH,32
988,889164364196044800,2017-07-23 16:44:38,14,2,16,False,AAAAAAAAAAAAAAAAAAAAAAAHHHHHHHHHHHHHH,37
989,889163242853060609,2017-07-23 16:40:11,0,0,0,True,@familyunequal AAAAAAAAHHHHHHHHHHHH,35
990,889161981864943617,2017-07-23 16:35:10,0,0,0,True,@BadHorseOC AAAAAAAAAAAAHHH,27
991,889161847424856064,2017-07-23 16:34:38,7,1,8,False,AAAAHHHHH,9
992,889159334923563008,2017-07-23 16:24:39,7,2,9,False,AAAAHHHHHHHHHHH,15
993,889156815770062849,2017-07-23 16:14:39,6,4,10,False,AAAAAAAAAAAAH,13
994,889154300022226945,2017-07-23 16:04:39,15,4,19,False,AAAAAAAAAAAAHHHHHHHHHHHHHHHH,28
995,889151783095988224,2017-07-23 15:54:39,11,2,13,False,AAHHHHHHHHHHHHHHH,17
996,889149265443991552,2017-07-23 15:44:39,9,3,12,False,AAAAAAAAAAAHHHHHHHHHHHHH,24
997,889146749045964800,2017-07-23 15:34:39,7,3,10,False,AAAAAAAAAAAAAAAAHHHHHH,22
998,889144238633611265,2017-07-23 15:24:40,12,3,15,False,AAAAAAAAAAAAAAAAAHHHHH,22
999,889144233315250177,2017-07-23 15:24:39,11,6,17,False,AAAAAAAAAAAAAAAAAHHHHHHHHHHH,28
1000,889141714946056192,2017-07-23 15:14:38,7,2,9,False,AAAAAAHHHHHHHHHHHHH,19
1001,889139200238465025,2017-07-23 15:04:39,8,0,8,False,AAAAAAAAHHHHHHH,15
1002,889136683387674629,2017-07-23 14:54:39,12,5,17,False,AAAAAAAAAAAAAAHHHHH,19
1003,889134165496655872,2017-07-23 14:44:39,9,3,12,False,AAAHHH,6
1004,889131652219367424,2017-07-23 14:34:39,11,5,16,False,AAAAAHHHHHHHHHHHHHH,19
1005,889129132558299136,2017-07-23 14:24:39,8,8,16,False,AAAAAAAAAAAAAAAAAAAAH,21
1006,889126618580561920,2017-07-23 14:14:39,9,1,10,False,"AAAAAAAAAAH 
https://t.co/h23hgBJBeD",36
1007,889124100886736896,2017-07-23 14:04:39,14,2,16,False,AAAAAAAAAAAHHHHHHHHHHHHHHHH,27
1008,889121582580457472,2017-07-23 13:54:39,6,2,8,False,AAAAAHHHHHH,11
1009,889119067923247104,2017-07-23 13:44:39,20,8,28,False,AAAAAAAAAAAAAAAAAAAAHHHHHHHH,28
1010,889116549503524865,2017-07-23 13:34:39,12,6,18,False,AAAAAHHHHHHHHHH,15
1011,889114034393546752,2017-07-23 13:24:39,7,1,8,False,AAAAAAAAAAAAAHHHHH,18
1012,889111517148446720,2017-07-23 13:14:39,5,1,6,False,AAHHHHH,7
1013,889109001765621762,2017-07-23 13:04:39,10,6,16,False,AHHHHHHHHHHHHHHH,16
1014,889106483736084480,2017-07-23 12:54:39,6,1,7,False,AAAAAAAAAAAAAHHHH,17
1015,889103968978305024,2017-07-23 12:44:39,14,1,15,False,AAAHHHHHHHHHHHHHHH,18
1016,889101449862541312,2017-07-23 12:34:39,12,1,13,False,AAAAAAAAAAAAAAAAAHHH,20
1017,889098934290972676,2017-07-23 12:24:39,9,1,10,False,AAAAAHH,7
1018,889096420975923204,2017-07-23 12:14:40,13,4,17,False,AAAAAAAAAAAAAAAAAAAHHHHHHHHHHHHHH,33
1019,889093902170546176,2017-07-23 12:04:39,13,2,15,False,AAAAAAAAAAAAAH,14
1020,889091382832451585,2017-07-23 11:54:38,11,1,12,False,AAAAAAAAAAAAAAAAAAAAAHHHHH,26
1021,889088869072809985,2017-07-23 11:44:39,10,2,12,False,AAAAAAAAAAHHHHHHHHHHHH,22
1022,889086352196808705,2017-07-23 11:34:39,11,6,17,False,AAAHHHHHHHHHHHHHHHH,19
1023,889083837220827136,2017-07-23 11:24:39,13,3,16,False,AAAAAAAAAAAAAAAAAAAAAHHHHHHHH,29
1024,889081318654570496,2017-07-23 11:14:39,10,0,10,False,AAAAAAAAAAAAAAAAAAHHHHHHHHHHH,29
1025,889078801946333184,2017-07-23 11:04:39,8,4,12,False,AAAAAHHHHHHHHHHHHHHHH,21
1026,889076285657448452,2017-07-23 10:54:39,3,1,4,False,AAAAAAAAAAAAAAAHHHHHHHHHHHHHHHH,31
1027,889073769293152257,2017-07-23 10:44:39,5,3,8,False,AAAAAAAHHHHHHH,14
1028,889071251444072448,2017-07-23 10:34:39,13,8,21,False,AAAAAAAAAAAAAAAAAAAAAHHHHHHHHHHHHH,34
1029,889070128729649153,2017-07-23 10:30:11,0,0,0,True,@defectiveMom AAAAAAAAAAAAAAAHHHHHHHH,37
1030,889068737176981504,2017-07-23 10:24:39,26,14,40,False,AAAAAAAAAAHHHHHHHHHHHHH,23
1031,889066217524387840,2017-07-23 10:14:38,11,1,12,False,AAAAAAAAAAAAAAAAAHHHHHHHH,25
1032,889063705018761216,2017-07-23 10:04:39,4,0,4,False,AAAAAAAHH,9
1033,889061186037272576,2017-07-23 09:54:39,10,1,11,False,AAAAAAAAAAAAAAAAAAAAAAH,23
1034,889058668997726208,2017-07-23 09:44:39,10,2,12,False,AAAAAAAAHHHHHHHH,16
1035,889056153648455680,2017-07-23 09:34:39,6,1,7,False,AAAAAAAAAHHHHHH,15
1036,889053636537593856,2017-07-23 09:24:39,7,5,12,False,AAAAAAAAAAAAAAAHHHHH,20
1037,889051119342714881,2017-07-23 09:14:39,9,2,11,False,AAAAAAAAAAAAAAAAAAAAAAAHHHH,27
1038,889048602714279937,2017-07-23 09:04:39,7,0,7,False,AAAAAAAAAHH,11
1039,889046086131888128,2017-07-23 08:54:39,7,1,8,False,AAAAAAAAAAAAAAAAAAHHHHHHHHHH,28
1040,889043571269087233,2017-07-23 08:44:39,12,3,15,False,AAAAAAAAAAAAAAAAAAHHHHHHHHH,27
1041,889041054418292736,2017-07-23 08:34:39,5,2,7,False,AAAAH,5
1042,889038538360184832,2017-07-23 08:24:39,12,2,14,False,AAAAAAAAAAAAAAAAHHHHHHHHHHHHHH,30
1043,889036029784731649,2017-07-23 08:14:41,12,5,17,False,AAAAAAAAAAAAAAAAAAAAHHHHHHHHHHHHH,33
1044,889033514276052992,2017-07-23 08:04:41,8,3,11,False,AAAAAAAAAAAAAAHHHH,18
1045,889030993973317633,2017-07-23 07:54:41,6,0,6,False,AAHHH,5
1046,889028478191972352,2017-07-23 07:44:41,20,12,32,False,AAAAAAAAAAAAAHHHHHHHHHHHH,25
1047,889025960389074945,2017-07-23 07:34:40,12,2,14,False,AAAAAAAAAAAAHHHHHHHHHHH,23
1048,889024829172666369,2017-07-23 07:30:11,2,0,2,True,@lusenneleite AAAAAAAAAAAAAAHH,30
1049,889023570394976256,2017-07-23 07:25:11,3,0,3,True,@Daryki AAAAHH,14
1050,889023446549712896,2017-07-23 07:24:41,9,2,11,False,AAHHHHHHHHHH,12
1051,889021051514101761,2017-07-23 07:15:10,0,0,0,True,@auftrittssucht AAAAHHHHHHHHHHHHH,33
1052,889020930168696833,2017-07-23 07:14:41,11,5,16,False,AAAAAAAHHHHHHHHHHHHHH,21
1053,889018412567076864,2017-07-23 07:04:41,15,7,22,False,AAAAAAAAAAAAAHHHHHHHHHHHHHHH,28
1054,889016020706447361,2017-07-23 06:55:11,0,0,0,True,@KristianHarstad AAAAAAAAAAAAAAAAAAHHHH,39
1055,889015897272266752,2017-07-23 06:54:41,7,2,9,False,AAAAAAHHHH,10
1056,889013377758003200,2017-07-23 06:44:40,6,2,8,False,AAAAAAAAAAAAAAAHHHHHHH,22
1057,889010865130934276,2017-07-23 06:34:41,10,4,14,False,AAAAAAAAAAAAAAAAAAAAAAHHHHHHHHHHHHHHH,37
1058,889008344886726658,2017-07-23 06:24:41,6,1,7,False,AAAAAHHH,8
1059,889007213485977601,2017-07-23 06:20:11,0,0,0,True,@Tendrin AAHHHHHHH,18
1060,889005827570495488,2017-07-23 06:14:40,3,0,3,False,AAAAAAAAAAAAHH,14
1061,889003314444107777,2017-07-23 06:04:41,5,1,6,False,AAAAAAAHHH,10
1062,889000797207441408,2017-07-23 05:54:41,6,2,8,False,AAAAAAAAAAAAAAAHHH,18
1063,888998281925230592,2017-07-23 05:44:41,19,8,27,False,AAAAAAAAAAAAAAAAAAAAAAAHHHHHHHHHH,33
1064,888997151250022404,2017-07-23 05:40:12,1,0,1,True,@h1gg5b0s0n AAAAAAAAAHHHHHH,27
1065,888995761031184384,2017-07-23 05:34:40,12,1,13,False,AAH,3
1066,888994630699823104,2017-07-23 05:30:11,0,0,0,True,@Drk24and7 AAAAAAAAAAAAAAAAAAAAAAHHH,36
1067,888993247649034241,2017-07-23 05:24:41,13,2,15,False,AAAAAAAAAAAAAAAAAAAAAHHHHHHHHHHH,32
1068,888990721012891648,2017-07-23 05:14:39,21,7,28,False,AAAAAAAHHHHHHHH,15
1069,888988204711411712,2017-07-23 05:04:39,14,5,19,False,AAAAAAHHHHHHHHHHH,17
1070,888985687462211585,2017-07-23 04:54:39,14,9,23,False,AAAAAAAAAAAAAAAAAHHHHHHHHHHHHHHHH,33
1071,888983170338697216,2017-07-23 04:44:38,14,4,18,False,AAAAAAAAAAAAAAAAAAAAAAAHHHHHHHHHHHH,35
1072,888980656927145984,2017-07-23 04:34:39,14,3,17,False,AAAAAAAAAAAAAAAAAAAAAAHHHHHHH,29
1073,888978269999181825,2017-07-23 04:25:10,2,1,3,True,@BobKronbauer AAAAAAAAAAAAAHHHHHHHHHHH,38
1074,888978139392737280,2017-07-23 04:24:39,9,3,12,False,AAAAAAAAAAAAAAAAAHH,19
1075,888977018687246336,2017-07-23 04:20:12,0,0,0,True,@simonplittle AAAAAHHHHHHHHHHHH,31
1076,888975622273466369,2017-07-23 04:14:39,12,5,17,False,AAAHHHHHHHH,11
1077,888973107247157249,2017-07-23 04:04:39,10,2,12,False,AAAHHHHHHHHHH,13
1078,888970588001382400,2017-07-23 03:54:39,18,13,31,False,AAAAAAAAAAAAAAAAAAAHH,21
1079,888968070554935297,2017-07-23 03:44:38,6,3,9,False,AHHHHHHHHHHH,12
1080,888965555520143360,2017-07-23 03:34:39,7,0,7,False,AAAAAAAAAAAAHHHHHHHHHHHH,24
1081,888963038384181248,2017-07-23 03:24:39,13,5,18,False,AAAAAAAAAAHHHHH,15
1082,888961914977603584,2017-07-23 03:20:11,0,1,1,True,@mirindacrissman AAAAHHHHHHHHHHHHH,34
1083,888960521524977664,2017-07-23 03:14:39,16,4,20,False,AAAAAAAAAAAAHHHHHHHHHH,22
1084,888958004586041344,2017-07-23 03:04:38,12,7,19,False,AAAAAAAAAAAAAAAAAAAAAAHHHH,26
1085,888955491598180352,2017-07-23 02:54:39,21,7,28,False,AAAAAAAAAAAAAAAAAAAAAAHHHHHHHHHHHHHHHH,38
1086,888952974508257280,2017-07-23 02:44:39,11,1,12,False,AAAAAAAAAAAAAAAAAAAAAAAH,24
1087,888950455035940870,2017-07-23 02:34:39,7,0,7,False,AAAAAAAAAAAHHHHH,16
1088,888947941079175169,2017-07-23 02:24:39,9,1,10,False,AAAAHHHHH,9
1089,888945423666302978,2017-07-23 02:14:39,10,1,11,False,AAAAAAAAAHHHHHHHHHHHHHH,23
1090,888942906475769856,2017-07-23 02:04:39,6,0,6,False,AAAAAAHHHHHHHHH,15
1091,888940388819640320,2017-07-23 01:54:39,8,4,12,False,AAAAAAAAAAAAAAHHHHHHHHHHHH,26
1092,888937872132386816,2017-07-23 01:44:39,13,5,18,False,AAAAAAAAAAAAAAAAAAHHHHHH,24
1093,888935357387083777,2017-07-23 01:34:39,10,3,13,False,AAAAAAAAAAAAAAAAAAAAAH,22
1094,888932840590725120,2017-07-23 01:24:39,10,7,17,False,AAAAAAAAAAAAAAAAAHHHH,21
1095,888931718094352384,2017-07-23 01:20:11,1,0,1,True,@mo_rf_i AAAAAAAAAAAAAAAAHHHHHHH,32
1096,888930457169121281,2017-07-23 01:15:11,0,0,0,True,@mo_rf_i AAAAAAAAAAAAAAAAAAAAAHHHHH,35
1097,888930325631557632,2017-07-23 01:14:39,8,2,10,False,AAAAAAAAAAAAAHHHHHH,19
1098,888929203982401537,2017-07-23 01:10:12,0,0,0,True,@unfitforpurpose AAAAAHHH,25
1099,888927939911438336,2017-07-23 01:05:11,1,0,1,True,@h1gg5b0s0n AAAHH,17
1100,888927808206012416,2017-07-23 01:04:39,8,1,9,False,AHHHHHHHHHH,11
1101,888925289362993152,2017-07-23 00:54:39,11,4,15,False,AAAAAAAAAAAHHHHHHHHHHH,22
1102,888922775423004672,2017-07-23 00:44:39,9,2,11,False,AAAAAAAAAAAAAAAHHHHHHHHH,24
1103,888920257167056897,2017-07-23 00:34:39,12,3,15,False,AAAAAAAAAAAAAAHHHHHHHH,22
1104,888917741394112513,2017-07-23 00:24:39,12,1,13,False,AAAHHHHHHHHHHHHHH,17
1105,888915224732069888,2017-07-23 00:14:39,9,2,11,False,AAAAHH,6
1106,888914105196847106,2017-07-23 00:10:12,0,0,0,True,@HelloImHarrie AAAAAAAAAAAAAAAAAAAAAHHH,39
1107,888912708652990464,2017-07-23 00:04:39,10,0,10,False,AAHHHHHHHHH,11
1108,888910192234123264,2017-07-22 23:54:39,19,6,25,False,AAAAAAAAAAAAAAAAAAHHHHHHHHHHHHHH,32
1109,888907673470676992,2017-07-22 23:44:39,7,4,11,False,AAAAAAAAAAAAAAAHHHHHHHHHH,25
1110,888905159685918720,2017-07-22 23:34:39,10,2,12,False,AAAAAAAAAAAAAAAHHHHHHHHHHHHH,28
1111,888902643288084480,2017-07-22 23:24:39,7,5,12,False,AAHHHHHHHHHHHHHHHH,18
1112,888900123413151744,2017-07-22 23:14:39,9,3,12,False,AAAAAAAAAAAAAAAAAAAAAHHHHH,26
1113,888899001126400000,2017-07-22 23:10:11,0,0,0,True,@ahmedtakrouri AAAAHHHHHHHHHHHHHHHH,35
1114,888897609896796160,2017-07-22 23:04:39,10,3,13,False,AHHHHH,6
1115,888895089879240704,2017-07-22 22:54:38,12,0,12,False,AAAAAAAAAAAAAAAAAAAHHHH,23
1116,888892573342990337,2017-07-22 22:44:38,16,3,19,False,AAAAAAAAAAAAAAAAAAAAAAAHHHHHHHHHHHHHHHH,39
1117,888890057591070721,2017-07-22 22:34:39,9,3,12,False,AAAAAAAHHHHHHHHHHHHH,20
1118,888887540576432128,2017-07-22 22:24:39,17,5,22,False,AAAAAAAAAAAAAAAHHHHHHHHHHHH,27
1119,888885025797804034,2017-07-22 22:14:39,12,5,17,False,AAAAAAAAAAAAAAAHH,17
1120,888882510326837248,2017-07-22 22:04:39,11,1,12,False,AAAAAAAAHHHHHHHHH,17
1121,888879992649768960,2017-07-22 21:54:39,13,1,14,False,AAAAAAAAAAAAAAAAAAAAHHHHHH,26
1122,888877473567567872,2017-07-22 21:44:38,9,1,10,False,AAAAAAAAAAAAAAHHHHHHHHHH,24
1123,888875090150084609,2017-07-22 21:35:10,0,0,0,True,@4plydoor AAAH,14
1124,888874959568850944,2017-07-22 21:34:39,11,7,18,False,AAAAAAAAAAAAAHHHHHHHHHHHHH,26
1125,888872444651556864,2017-07-22 21:24:39,12,2,14,False,AAAAAAAAAAAHHH,14
1126,888871322083876866,2017-07-22 21:20:12,1,0,1,True,@__redcat AAHHHHH,17
1127,888871322079637504,2017-07-22 21:20:12,0,0,0,True,@GarionCoyote AAAAAAAAAAAAAAAAAAAAAH,36
1128,888869926127243264,2017-07-22 21:14:39,10,2,12,False,AAAAAAAAAAAAHHHH,16
1129,888867408378822656,2017-07-22 21:04:39,12,4,16,False,AAAAAAAAAAAAAAAAAAAAAAHHHHH,27
1130,888864891028860928,2017-07-22 20:54:38,4,1,5,False,AHHHHHHHHH,10
1131,888862376400965632,2017-07-22 20:44:39,11,7,18,False,AAAAAAAAAAAAHHHHHHHHH,21
1132,888859992396365824,2017-07-22 20:35:11,0,0,0,True,@drosenbig AAAAAAAAAAAHHHHHHHH,30
1133,888859860821049344,2017-07-22 20:34:39,11,4,15,False,AAAAAAAAAAAAAAHHHHHHHHH,23
1134,888857344372862977,2017-07-22 20:24:39,11,3,14,False,AAAAAAAAAAAAAAHHHHHHH,21
1135,888854825324171264,2017-07-22 20:14:39,4,2,6,False,AAAAAAAAAAAAAHHHHHHH,20
1136,888853703897354241,2017-07-22 20:10:11,0,0,0,True,@drosenbig AAAAAHHHHHHH,23
1137,888852308745998338,2017-07-22 20:04:39,17,8,25,False,AAAAAAAAAAAAAAAAHH,18
1138,888849791786078208,2017-07-22 19:54:39,7,2,9,False,AAAAAAAAAAAAAAHHHHHHHHHHH,25
1139,888847276113879040,2017-07-22 19:44:39,8,4,12,False,AAAAAAAAAAAAAAAAHHH,19
1140,888844759279828992,2017-07-22 19:34:39,18,8,26,False,AAAAAAAAAAAAAAAAAAAAHHHHHHHHHHHHHHHH,36
1141,888842243506925568,2017-07-22 19:24:39,13,4,17,False,AAAAAHHHHHHHHHHHHHH,19
1142,888839728719683584,2017-07-22 19:14:39,7,4,11,False,AAAAAAH,7
1143,888837213064228866,2017-07-22 19:04:40,10,7,17,False,AAAAAAAAAAAAAAAAAAHHHHHHHHHHH,29
1144,888834694757920770,2017-07-22 18:54:39,5,2,7,False,AAAAAAAAAAAAAAAAAH,18
1145,888833574551658497,2017-07-22 18:50:12,1,0,1,True,@ewsiii AAAAAAAAAAAAAAAAAAAHHHHHHHHHH,37
1146,888832176833298433,2017-07-22 18:44:39,7,3,10,False,AAAAAAAAAAH,11
1147,888829661765144578,2017-07-22 18:34:39,10,4,14,False,AAAAAAAAAAAAAAAAAAAAHHHHHHHHHHHH,32
1148,888827145769889792,2017-07-22 18:24:39,9,5,14,False,AAAAAAAAAAAAAHH,15
1149,888824762427990019,2017-07-22 18:15:11,0,0,0,True,@Avocados_0 AAAAAAAAAAAAAAAAAAAAAAHHHHHHHHHHHHH,47
1150,888824629254656001,2017-07-22 18:14:39,4,1,5,False,AHHHHHHH,8
1151,888822112697372675,2017-07-22 18:04:39,5,1,6,False,AAHHHHHHHHHHH,13
1152,888819592260464645,2017-07-22 17:54:38,8,1,9,False,AAAAHHHHHHHH,12
1153,888817077276078081,2017-07-22 17:44:39,9,2,11,False,AAAAAAAAAAAAHH,14
1154,888814562182660097,2017-07-22 17:34:39,8,1,9,False,AHHHHHHHHHHHHHHH,16
1155,888812046116106243,2017-07-22 17:24:39,7,1,8,False,AAAAAAAAAAAAAAAAHHHHH,21
1156,888810924492169216,2017-07-22 17:20:12,0,0,0,True,@kuutarhuri AAAAAAAAAAAAAAAAAHHHHHHHHHHHHHHH,44
1157,888809528594243584,2017-07-22 17:14:39,28,17,45,False,AAAAAAAAAAAAAAAAAAAAAAHHHHHHHHHHHHH,35
1158,888807145348706306,2017-07-22 17:05:11,0,0,0,True,@MelanistOnca AAAAAAAAAAAAAAAAHHHHHHHHHHHHHHH,45
1159,888807013089779712,2017-07-22 17:04:39,16,3,19,False,AAAAAAAAAAAAAAAAAAAAHHHHHHH,27
1160,888804495911727104,2017-07-22 16:54:39,11,2,13,False,AAAAAAAHHHHHH,13
1161,888801977269964800,2017-07-22 16:44:39,18,4,22,False,AAAAAAAAAAAAAAAAAAAAAAAHHHHHHHHH,32
1162,888799593839939584,2017-07-22 16:35:10,0,0,0,True,@dammit_rick AAAAAAAAHH,23
1163,888799461006331908,2017-07-22 16:34:39,10,6,16,False,AAAAAAAAAAAAAAAAHHHHHHHHHHHHH,29
1164,888796945669652480,2017-07-22 16:24:39,16,2,18,False,AAAAAAAAAAAAAAAAAAHHHH,22
1165,888794427849928704,2017-07-22 16:14:39,6,5,11,False,AAAAAAAAHHHH,12
1166,888791910835519488,2017-07-22 16:04:39,9,3,12,False,AAHHHHHHHHHHHHHH,16
1167,888789395754672129,2017-07-22 15:54:39,20,8,28,False,AAAAAAAAAAAAHHHHHHHHHHHHHHH,27
1168,888786880606679042,2017-07-22 15:44:39,8,6,14,False,AAAAAAAAAAAAAAAAAAAAHHHH,24
1169,888784360320708611,2017-07-22 15:34:38,9,4,13,False,AAAAAAHHHHHHHHHHHHHHH,21
1170,888781844564586497,2017-07-22 15:24:39,7,2,9,False,AAAAAHHHHHHHHHH,15
1171,888780723452338177,2017-07-22 15:20:11,1,0,1,True,@defectiveMom AAAAAAAAAAAAAAAAAHHHHHHHHHHHHHHHH,47
1172,888779329282473984,2017-07-22 15:14:39,8,1,9,False,AAAHHHHHHHHHHHHH,16
1173,888776811693436928,2017-07-22 15:04:39,9,4,13,False,AAAAAAAAAAHHHHHHHHHHHH,22
1174,888774295119429632,2017-07-22 14:54:39,7,1,8,False,"AAAAAAH 
https://t.co/deNl6Na4DJ",32
1175,888771781540155392,2017-07-22 14:44:39,10,2,12,False,AAAAAHHHHHH,11
1176,888769260599861249,2017-07-22 14:34:38,10,2,12,False,AAAAAAAAAAAAAHHHHHHHH,21
1177,888766745871298560,2017-07-22 14:24:39,9,2,11,False,AAAAAAAAHHHHHHHHHHHHHHH,23
1178,888764231184723968,2017-07-22 14:14:39,13,8,21,False,AAAAAAAAAAAAAAAAAAAAAAHHHHHHHHHHHHHHH,37
1179,888761844315418625,2017-07-22 14:05:10,0,0,0,True,@Sihayanami AAAAAAAAAAAAAAAAAHHHHHHHHHHHHHH,43
1180,888761711616040960,2017-07-22 14:04:39,13,1,14,False,AAAAAAAAHHHHHHHHHHHHHHHH,24
1181,888759196002508801,2017-07-22 13:54:39,7,2,9,False,AAAAAAAAAAAAAAAAAAHHHHHHHHHH,28
1182,888756680347013120,2017-07-22 13:44:39,8,1,9,False,AAAAAAAAAHHHHHH,15
1183,888754161772351489,2017-07-22 13:34:39,12,5,17,False,AAAAAAAAAAAHHHHHHHHHHHHH,24
1184,888751645764583426,2017-07-22 13:24:39,10,1,11,False,AAAAAAAAAAAAHHHHHHH,19
1185,888749127877746692,2017-07-22 13:14:38,11,3,14,False,AAAH,4
1186,888746615548280832,2017-07-22 13:04:39,6,1,7,False,AAAHHHHHH,9
1187,888744097141448705,2017-07-22 12:54:39,29,14,43,False,AAAAAAAAAAAAAAAAAAAAHHHHHHHHHHHHH,33
1188,888741582110945282,2017-07-22 12:44:39,3,1,4,False,"AAAAAAAAAAAAAHHHHHHHHHHHHHHHH 
https://t.co/cJJofLJO7W",54
1189,888739063326494720,2017-07-22 12:34:39,16,6,22,False,AAAAAAAAAAAAAHHHHHHHHHHHHHHH,28
1190,888736547318751233,2017-07-22 12:24:39,5,0,5,False,AAAAAAAAHHH,11
1191,888734031252250624,2017-07-22 12:14:39,3,2,5,False,AAAAAAAAAAAAAAAAAAAHHHHHHH,26
1192,888731515311599616,2017-07-22 12:04:39,6,3,9,False,AAAAAAAAAAAAAAAAAAAHHHHHH,25
1193,888728998741716993,2017-07-22 11:54:39,9,2,11,False,AAAAAAAAAHHHHHHHHHHHHHHH,24
1194,888726481274318848,2017-07-22 11:44:39,4,1,5,False,AAAAAAAAAAAAAAAAAAAAAAHHHHHH,28
1195,888723973713821697,2017-07-22 11:34:41,11,3,14,False,AAAAAAAAAAAAAAAAAHHHHHHHHHHHHHHHH,33
1196,888721456514904068,2017-07-22 11:24:41,9,2,11,False,AAAAAAAAAAAAAAAAAAAHHHHHHHHHHHHHHHH,35
1197,888718939257229313,2017-07-22 11:14:41,8,1,9,False,AAAAAAAH,8
1198,888716423438241792,2017-07-22 11:04:41,6,2,8,False,AAAAAAAAAAAAAAAAAAHHHHH,23
1199,888713905316515840,2017-07-22 10:54:41,5,0,5,False,AAAAAAAAAAAAAAAAAAAAAAH,23
1200,888711388897705989,2017-07-22 10:44:41,7,1,8,False,AAAAAHHHHHHHHHHHH,17
1201,888708872764088324,2017-07-22 10:34:41,13,5,18,False,AAH,3
1202,888706353983873024,2017-07-22 10:24:40,10,4,14,False,AHHHHHHHHHHHHHH,15
1203,888703831340613634,2017-07-22 10:14:39,12,2,14,False,AAAAAAAAAAHHHHHHHHHHHHHHH,25
1204,888701315144142854,2017-07-22 10:04:39,7,2,9,False,AAAAAAAAAAAAAAAAAAHHHHHHHHHHHHHH,32
1205,888698799413223424,2017-07-22 09:54:39,6,1,7,False,AAAAAAAAAAAAAHHHHHHHHHHH,24
1206,888696282189094913,2017-07-22 09:44:39,5,1,6,False,AAAAAAAAHH,10
1207,888693765908684801,2017-07-22 09:34:39,4,0,4,False,AAAAAAAAAAHHHHHHHHHHH,21
1208,888691247229153280,2017-07-22 09:24:39,3,1,4,False,AAAAAAAAAAAAAHHHHH,18
1209,888688733725351936,2017-07-22 09:14:39,8,5,13,False,AAAAAAAAAAAAAAAAAAAAAAHHHHHHHHHHHHHH,36
1210,888686214781562880,2017-07-22 09:04:39,4,0,4,False,AAAAAAAAAAAAAAHHHHHHHHHHHHHHHH,30
1211,888683699277004800,2017-07-22 08:54:39,5,6,11,False,AAAAAAAHHHHHHHHHHHHHHH,22
1212,888681182791163904,2017-07-22 08:44:39,6,2,8,False,AAAAAAAAAAAAAAHHHHHHHHHHHH,26
1213,888678666967928833,2017-07-22 08:34:39,6,0,6,False,AAAAAAAAAHHHHHHHHHHHHHHHH,25
1214,888676150335209472,2017-07-22 08:24:39,9,2,11,False,"AAAAAAAAAAAAAAAAHHHHHHHHHHH 
https://t.co/RCixkFG5QR",52
1215,888673631718526981,2017-07-22 08:14:39,2,1,3,False,AHHHHHHHHHHHHHHHH,17
1216,888671116222443520,2017-07-22 08:04:39,4,0,4,False,AAAAAAAHHHH,11
1217,888668598721490944,2017-07-22 07:54:39,5,1,6,False,AAAAAAAAAAAAAAAAAAHHH,21
1218,888666213257293828,2017-07-22 07:45:10,0,0,0,True,@aishnazim AAAHHHHHHHHHHHH,26
1219,888666081199566848,2017-07-22 07:44:39,4,1,5,False,AAAAAAAAAAAAAAAAAAAAAAHHHHH,27
1220,888663566529810433,2017-07-22 07:34:39,4,0,4,False,AAAAAAAAAAAAH,13
1221,888662441726550016,2017-07-22 07:30:11,0,0,0,True,@ra7baa AAAAAAAAAAAAAAAAAAHHHH,30
1222,888662441676218368,2017-07-22 07:30:11,1,0,1,True,@Amethystinia AHHHHHHHHHHH,26
1223,888661182458015744,2017-07-22 07:25:11,0,0,0,True,@ra7baa AAAAAAHHHHHHHHHHHH,26
1224,888661048773009409,2017-07-22 07:24:39,3,0,3,False,AHHH,4
1225,888659926704410624,2017-07-22 07:20:11,0,0,0,True,@ra7baa AAAAAAAHHHHHHHHHHHHHHHH,31
1226,888658662184673280,2017-07-22 07:15:10,0,0,0,True,"@ra7baa AAAAAHHHHHHHHHH 
https://t.co/yV4Viu5hXX",48
1227,888658531368534016,2017-07-22 07:14:39,4,1,5,False,AAHHHH,6
1228,888657409081847809,2017-07-22 07:10:11,1,0,1,True,@LarkBrains AAAAHHHHHHHHH,25
1229,888656015364943872,2017-07-22 07:04:39,12,5,17,False,AAAAAAAAAAAAAAAAAAHHHHHHHHHHH,29
1230,888653498853863424,2017-07-22 06:54:39,5,4,9,False,AAAAAAAAAAAAAAAAAAHHHHHHHHH,27
1231,888650985924698112,2017-07-22 06:44:40,5,0,5,False,AAAAAAAAAAAAAAHHHHHH,20
1232,888648467786194944,2017-07-22 06:34:39,5,4,9,False,AAAAAAAAAAAAAAAHHHHHHHHHHHHHHH,30
1233,888647346384502785,2017-07-22 06:30:12,0,0,0,True,@ra7baa AAAAAAAAAAAAAAAAAAHHHHHHHHHHHHHH,40
1234,888645948792074240,2017-07-22 06:24:39,11,5,16,False,AAAAAAAAAAAAAAAAAAAAAAHHHHHHHHHH,32
1235,888643434369699840,2017-07-22 06:14:39,7,0,7,False,AAAAAAAAHHHHHHHH,16
1236,888641049983418371,2017-07-22 06:05:11,1,0,1,True,@ex_al_ted AAAAAHHHHHHHHHHHHH,29
1237,888640918135459844,2017-07-22 06:04:39,8,2,10,False,AHHHHHHH,8
1238,888638398923190272,2017-07-22 05:54:39,13,2,15,False,AAAAAAAAAAAAAAAAAAAHHHH,23
1239,888635884043726848,2017-07-22 05:44:39,6,2,8,False,AAAAAAAAAHHHHHHHHHHHHHH,23
1240,888633368111460352,2017-07-22 05:34:39,13,6,19,False,AAAAAAAAAAAAAAHHHHHHHHHHH,25
1241,888630849788399616,2017-07-22 05:24:39,20,8,28,False,AAAAAAAAAAAAAAAAHHHHHHHHHHH,27
1242,888628333780639745,2017-07-22 05:14:39,6,2,8,False,AAAAAAAAAAAAAAHHHH,18
1243,888625818179702784,2017-07-22 05:04:39,5,1,6,False,AHHHHHHHH,9
1244,888623301614063617,2017-07-22 04:54:39,13,4,17,False,AAAAHHHHHHHHHHHHH,17
1245,888620785669165056,2017-07-22 04:44:39,6,2,8,False,AHHHHHHHHHH,11
1246,888618266599579648,2017-07-22 04:34:39,12,2,14,False,AAAAAAAAAAAAAAAAAAAAAAAH,24
1247,888615749971050497,2017-07-22 04:24:39,7,5,12,False,AAAAAAAAAAAAAAAAAAAAAAHHHHHHH,29
1248,888613235179610112,2017-07-22 04:14:39,13,6,19,False,AAAAAAAAAAAAAAAAAAHHHHHHH,25
1249,888610717674463232,2017-07-22 04:04:39,12,3,15,False,AAAAAAAAAAAAAAAAAAAHHHHHHHHHH,29
1250,888608200936894464,2017-07-22 03:54:39,19,7,26,False,AAAAAAAAAAAAAAAAAAAAAHHHHHHHHHHH,32
1251,888605685914664965,2017-07-22 03:44:39,16,8,24,False,AAAAAAAAAAAAAAAAHHHHHHHHHHHHHH,30
1252,888603166392057856,2017-07-22 03:34:38,11,2,13,False,AAAAAAHHHHHHHHHHH,17
1253,888600650187239425,2017-07-22 03:24:39,9,1,10,False,AAHHHHHHHH,10
1254,888598136230424576,2017-07-22 03:14:39,10,1,11,False,AAAHHHHHHHHHHHHHH,17
1255,888595620159684608,2017-07-22 03:04:39,13,4,17,False,AAAAAAAAAAAAAAHHHHHHHHHHHHH,27
1256,888593101740273672,2017-07-22 02:54:39,14,7,21,False,AAAAAAAAAAAAAAAH,16
1257,888590585766006788,2017-07-22 02:44:39,6,4,10,False,AAAAHHHH,8
1258,888589463374503936,2017-07-22 02:40:11,1,1,2,True,@BeKindOkk AAAAAHHHH,20
1259,888588067413651456,2017-07-22 02:34:39,10,4,14,False,AAAAAAAAAAAAHHHHHH,18
1260,888585552877854721,2017-07-22 02:24:39,12,2,14,False,AAAAAAHHHHHHHHH,15
1261,888583033934290945,2017-07-22 02:14:39,17,5,22,False,AAAAAAAHHHHHHHHHHHHHHHH,23
1262,888580519318790146,2017-07-22 02:04:39,17,6,23,False,AAAAAAAAAAAAAAHHHHHHH,21
1263,888579400236716033,2017-07-22 02:00:12,0,0,0,True,@c_life4_life AAAAAAAAAAAAHH,28
1264,888577999913627648,2017-07-22 01:54:38,11,6,17,False,AAAAAAAAAAAAAHHHHHHHHHH,23
1265,888575488230404097,2017-07-22 01:44:39,9,4,13,False,AAHHHHHH,8
1266,888572969672486917,2017-07-22 01:34:39,8,3,11,False,AAAAHHHHHHH,11
1267,888570454675308544,2017-07-22 01:24:39,13,6,19,False,AAAAAAAAAAAAAAAAAAAAHHHHHHHHHHHHHH,34
1268,888567934603460608,2017-07-22 01:14:39,11,7,18,False,AAAAAAAAAHHH,12
1269,888565419874721793,2017-07-22 01:04:39,11,4,15,False,AAAAHHHHHHHHHHHHHH,18
1270,888562901379940352,2017-07-22 00:54:39,14,4,18,False,AAAAAAAAAAHHH,13
1271,888560384860446721,2017-07-22 00:44:39,7,2,9,False,AAAAHH,6
1272,888557871624986626,2017-07-22 00:34:39,14,8,22,False,AAAAAAAAAAAAAAAAAAAHHHHHHHHHHHHHH,33
1273,888555353893466116,2017-07-22 00:24:39,16,12,28,False,AAAAAAAAAAAAAAAAAAHH,20
1274,888552836094713856,2017-07-22 00:14:39,11,1,12,False,"AAAAAAAAHHHHHHHHH 
https://t.co/h23hgBJBeD",42
1275,888550322699780096,2017-07-22 00:04:40,12,3,15,False,AAAAAAAAAHHHHHH,15
1276,888547802988597248,2017-07-21 23:54:39,17,6,23,False,AAAAAAAAAAAAAAAAAAAHHHHHHHHH,28
1277,888545286414532610,2017-07-21 23:44:39,15,7,22,False,AAAAAAAAAAAAAAAAAAAAAHHHHHHHHHHHHHHHH,37
1278,888542770109009920,2017-07-21 23:34:39,11,2,13,False,AAAAAAAAAAAAAAAAAAAH,20
1279,888541649827110912,2017-07-21 23:30:12,0,0,0,True,@scottohara AAAAAAAHHH,22
1280,888540253123993600,2017-07-21 23:24:39,10,5,15,False,AAAAAAHHHHHH,12
1281,888537736310870016,2017-07-21 23:14:39,37,16,53,False,AAAAAAAAAAAAHHHH,16
1282,888535219569119232,2017-07-21 23:04:39,13,3,16,False,AAHHHHHHHHHHH,13
1283,888532702915436544,2017-07-21 22:54:39,10,3,13,False,AAAAAAAAAAAHHHHHHHHHH,21
1284,888530185649348609,2017-07-21 22:44:39,9,6,15,False,AAAAAAAAAAAAAAAAAAAAAAHHHHHHHHHHHHH,35
1285,888529062435672066,2017-07-21 22:40:11,0,0,0,True,@briankfriesen AAAAAAAAAAAAAHHH,31
1286,888527672661336064,2017-07-21 22:34:39,15,6,21,False,AAAAAAHHHHHHHHHHHH,18
1287,888525154208423937,2017-07-21 22:24:39,7,0,7,False,AAAAAAAAAH,10
1288,888522638208970752,2017-07-21 22:14:39,6,1,7,False,AAAH,4
1289,888520120976384001,2017-07-21 22:04:39,15,6,21,False,AAAAAAAAAAAAAAAAAAAHHHHHHHHHHHHHHHH,35
1290,888517737189957634,2017-07-21 21:55:11,0,0,0,True,@gokhanssari AAAAAHHHHHHHHHHHHHHHH,34
1291,888517602967826432,2017-07-21 21:54:39,8,0,8,False,AAAAAAAAAAAAAAAHHHHHHH,22
1292,888516481809625088,2017-07-21 21:50:11,0,0,0,True,@gokhanssari AHHHHH,19
1293,888515089371987970,2017-07-21 21:44:39,14,4,18,False,AAAAAAAAAAAAAAAAAAAAHHHHHHH,27
1294,888512572118499328,2017-07-21 21:34:39,7,2,9,False,AAHHHHHHH,9
1295,888510053967425537,2017-07-21 21:24:39,9,1,10,False,AAAAAAAAAAAAAAAAHHHHHH,22
1296,888507671845851136,2017-07-21 21:15:11,1,0,1,True,@defectiveMom AAAAAAAAAAAAAAAHH,31
1297,888507536772481024,2017-07-21 21:14:39,9,2,11,False,AAAAHHHHHHHHHHHHHHHH,20
1298,888506413512671233,2017-07-21 21:10:11,0,0,0,True,@JustinTrJackson AAAAAAAAAAAAAHHHHHH,36
1299,888505022941679616,2017-07-21 21:04:39,15,5,20,False,AAAHHHHHHHHHHHH,15
1300,888502505860198400,2017-07-21 20:54:39,6,0,6,False,AAAAAAAAAAAAHHH,15
1301,888499989932122112,2017-07-21 20:44:39,8,1,9,False,AAAHHHHHHHHHHHHH,16
1302,888497471877500930,2017-07-21 20:34:39,13,3,16,False,AAAAAAAAAAAAAAAAAAAAAAAHHHHHHHH,31
1303,888494956507254784,2017-07-21 20:24:39,13,5,18,False,AAAAAAAAHHHHHHHHHHHHHH,22
1304,888492437240397824,2017-07-21 20:14:39,9,2,11,False,AAAAAAAAAAAAAAAAAAAAHH,22
1305,888489921509457923,2017-07-21 20:04:39,8,4,12,False,AAAAAAAAAAAAAAAAAAHHHHHHHHHHHH,30
1306,888487404126052353,2017-07-21 19:54:39,6,6,12,False,AAAAAAAAAAAAAAAAHHHHHHHHHHHHH,29
1307,888484886557974528,2017-07-21 19:44:38,7,4,11,False,AAAAAAAAAAAAAAAHHHHHHHHH,24
1308,888482371871354881,2017-07-21 19:34:39,11,2,13,False,AAAAAAAAAHHHHHHHHHHHHH,22
1309,888479856601829376,2017-07-21 19:24:39,8,3,11,False,AAAAAAAAHHHHHHHHHHHHHHHH,24
1310,888477340816347136,2017-07-21 19:14:39,8,0,8,False,AAAHHHHHHHHHHH,14
1311,888474821012705281,2017-07-21 19:04:39,7,1,8,False,AAAAAAAAAAAAAAAAAHHH,20
1312,888472304967188480,2017-07-21 18:54:39,11,1,12,False,"AAAAAAAAAAAAAAAHHHHHHHHHH 
https://t.co/deNl6Na4DJ",50
1313,888469787671576576,2017-07-21 18:44:39,4,3,7,False,AAAAAAAAAAAAAAAAAH,18
1314,888467274692272128,2017-07-21 18:34:39,6,3,9,False,AAAAAAAAAHHHHH,14
1315,888464757442977792,2017-07-21 18:24:39,10,4,14,False,AAAAAAAAAAAAAAAAAHHHHH,22
1316,888462241284186112,2017-07-21 18:14:39,9,2,11,False,AAAAAAAAAAAAAAAHHHHHHHHHHHHHHH,30
1317,888459724341084161,2017-07-21 18:04:39,11,1,12,False,AAAAAAAAAAAAAAAAAHHHHHHHHHHHHHHH,32
1318,888457207544762369,2017-07-21 17:54:39,7,3,10,False,AAAAAAHHHHHHHHH,15
1319,888454691599904773,2017-07-21 17:44:39,12,1,13,False,AAAAAAAAAAAAAAAHHHHHH,21
1320,888452175139147777,2017-07-21 17:34:39,11,2,13,False,AAAAAAAAAAAAAAAAAAAAHHHHHHHHHHH,31
1321,888449792258527232,2017-07-21 17:25:11,0,0,0,True,@billybudd0 AAAAAAAAAAAAAAAAAAAAAAAHH,37
1322,888449657654972418,2017-07-21 17:24:39,9,1,10,False,AHHHHHHHHHHHHHH,15
1323,888447139822673920,2017-07-21 17:14:39,9,1,10,False,AAAAAAAAAAAAAAAAAAAAHHHHH,25
1324,888444622879563777,2017-07-21 17:04:39,9,3,12,False,"AAAAAAAAAAAAAHHHHHHHHHHHHH 
https://t.co/h23hgBJBeD",51
1325,888443503285596161,2017-07-21 17:00:12,0,0,0,True,@briankfriesen AAAAAAHHHH,25
1326,888442108465557504,2017-07-21 16:54:39,8,1,9,False,AAAAAAHHHHHHHHHHHHHH,20
1327,888439589857374208,2017-07-21 16:44:39,7,2,9,False,AAAAAAAAAAAAAAAAAHHHHHHH,24
1328,888437072658354176,2017-07-21 16:34:39,22,6,28,False,AAAAAAAAAAAAAAAAAAHHHHHHHH,26
1329,888435947997728769,2017-07-21 16:30:11,0,0,0,True,@strange_flavors AAAAAAAAAAAAAAAAAAAAAAHHHHHHHHHHHHH,52
1330,888434558731005952,2017-07-21 16:24:39,7,0,7,False,AAAAAAAAAAAAAAAAHHHHHHHHHHH,27
1331,888433436939177984,2017-07-21 16:20:12,2,0,2,True,@StephanieLahey AH,18
1332,888432040462479360,2017-07-21 16:14:39,8,6,14,False,AAAAAAAAAAAAAAHHHHHHHHHH,24
1333,888429525406765057,2017-07-21 16:04:39,10,4,14,False,AAAAAAHHHHHHHHHHHHHHHH,22
1334,888427008228818946,2017-07-21 15:54:39,11,7,18,False,AAAAAAAAAAAAAHHHHHH,19
1335,888424626581327872,2017-07-21 15:45:11,0,0,0,True,@sportsjefe AAAAAAAAAAAAAAAHHHHHH,33
1336,888424489960304641,2017-07-21 15:44:39,9,1,10,False,AAAAHHHHH,9
1337,888421975336648704,2017-07-21 15:34:39,8,1,9,False,AHHHHHHH,8
1338,888419459576233986,2017-07-21 15:24:39,9,4,13,False,AHHHHHHHHHHHHH,14
1339,888416940271841280,2017-07-21 15:14:39,6,0,6,False,AHHH,4
1340,888414423546810369,2017-07-21 15:04:39,7,1,8,False,AAAAAAAHHHHHHHHHH,17
1341,888411906385620992,2017-07-21 14:54:39,12,6,18,False,AAAAAAAAAAAAAAAAAAHHHHHHH,25
1342,888409390545608704,2017-07-21 14:44:39,10,1,11,False,AAAAHHHHHHHHHHHHH,17
1343,888407006519980035,2017-07-21 14:35:10,0,0,0,True,@hall_mackey AAAAAAAAAAAAAAAAAAAHHHHHHH,39
1344,888406874432958464,2017-07-21 14:34:39,11,1,12,False,AAAAAAAAAAHHHHH,15
1345,888404358412587008,2017-07-21 14:24:39,7,5,12,False,AAAAAAHHHHHHH,13
1346,888403235622486016,2017-07-21 14:20:11,1,0,1,True,@hall_mackey AHHHHHHHH,22
1347,888401839540117504,2017-07-21 14:14:38,9,2,11,False,AAAAAAAAAAAAAAAHHHHHHHHHHH,26
1348,888399324098568193,2017-07-21 14:04:39,8,3,11,False,AAHHHHHHHH,10
1349,888396809848193024,2017-07-21 13:54:39,10,6,16,False,AAAAAAAAAAAAAAAAAAAAAAHHHH,26
1350,888395687934734336,2017-07-21 13:50:12,1,0,1,True,@cgriebel AAAAAAAAAHHHHH,24
1351,888394294012370945,2017-07-21 13:44:39,5,0,5,False,AAAAAAAAAAHHHHHHHHHHHHHH,24
1352,888391775257333760,2017-07-21 13:34:39,15,2,17,False,AAAAAAAAAAAAAAAAAAHHHHHHHHHHHH,30
1353,888389259689947136,2017-07-21 13:24:39,15,6,21,False,AAAAAAAAAAAAAAAAAAHHHHHHHHH,27
1354,888386741891104768,2017-07-21 13:14:39,4,3,7,False,AAHHHHHHHHHH,12
1355,888384360386371585,2017-07-21 13:05:11,0,0,0,True,@electricarchaeo AAAAAAAAAAAAAAAAAAAAHHHHHHHHHHHHHH,51
1356,888384230161514497,2017-07-21 13:04:40,7,4,11,False,AAAAHHHHHHHHH,13
1357,888381841937494016,2017-07-21 12:55:11,2,0,2,True,@liz_monster AAAAAAAAHHHHHH,27
1358,888381707438759936,2017-07-21 12:54:39,9,3,12,False,AAAAAAAAAAAAAAAAAAAAAAAHHH,26
1359,888379191825223680,2017-07-21 12:44:39,7,6,13,False,AAAAAAAAAHH,11
1360,888376675498643456,2017-07-21 12:34:39,12,3,15,False,AAAAAAAAAAAAAHHHHHHHHH,22
1361,888374159524474880,2017-07-21 12:24:39,8,3,11,False,AHHHHHHHHHH,11
1362,888371641436303361,2017-07-21 12:14:39,5,2,7,False,AAAAAAAAAAAAHHHHHH,18
1363,888369126699405312,2017-07-21 12:04:39,7,5,12,False,AAAAAAAAAAAAAAAHHHHHHHHHH,25
1364,888366609240338432,2017-07-21 11:54:39,13,7,20,False,AAAAAAAAAAAAAAAAAAAAHHHHHHHH,28
1365,888364092200816640,2017-07-21 11:44:39,6,0,6,False,"AAAAAAAAAAAAAAAAAAAAAAAHH 
https://t.co/GjpsuOA9j0",50
1366,888361577925292032,2017-07-21 11:34:39,4,4,8,False,AAAAAHH,7
1367,888359061422579712,2017-07-21 11:24:39,11,5,16,False,AAAAAAAAAAHHHHHHHHHH,20
1368,888356544219316225,2017-07-21 11:14:39,6,5,11,False,AAAAAAAHHHHHHHHHHH,18
1369,888354027972558848,2017-07-21 11:04:39,17,5,22,False,AAAAAAAAAAAAAAAAAAAAAAAHHHHHHHHHHHHHH,37
1370,888351507804024832,2017-07-21 10:54:38,6,6,12,False,AAAAAAAAAAAAAAAAAHHHHHHHHH,26
1371,888348994363109376,2017-07-21 10:44:39,13,7,20,False,AAAAAAAAAAAAAAAAAAAAAAHHHHHHHHHHHHHHHH,38
1372,888346477491363840,2017-07-21 10:34:39,6,5,11,False,AAAAAAAAHHHHHHHH,16
1373,888343959214452736,2017-07-21 10:24:39,8,9,17,False,AAAAAAAAAAAAAAAAAAAHHHHHHHHHH,29
1374,888341443978428416,2017-07-21 10:14:39,3,3,6,False,AHHHHHHHHHHHH,13
1375,888338928633294849,2017-07-21 10:04:39,3,1,4,False,AAAAAAAAAAAAAAAAHHH,19
1376,888336410142547971,2017-07-21 09:54:39,4,1,5,False,AHHHHHHHHHHHHHHH,16
1377,888333892469522432,2017-07-21 09:44:39,6,1,7,False,AAAAAAAAAAAAAAAAAHHHHHHHHHHHH,29
1378,888331376910643200,2017-07-21 09:34:39,5,1,6,False,AAAAAAAAHHH,11
1379,888328861053841408,2017-07-21 09:24:39,4,1,5,False,AAAAAAAAAAAAAHHHHHHH,20
1380,888326343313805312,2017-07-21 09:14:39,7,0,7,False,AAAAAAAAAAAAAAAAAAAAAAAHH,25
1381,888323829759692800,2017-07-21 09:04:39,3,0,3,False,AHHHHHHHHHHHHHHHH,17
1382,888321309410816000,2017-07-21 08:54:39,5,2,7,False,AAAAAAAAAAAAHHHHHHHHHHH,23
1383,888320187895865347,2017-07-21 08:50:11,0,0,0,True,@RachaelAye AAAAAAAAAAAAAAAHHHHHHH,34
1384,888318793105235968,2017-07-21 08:44:39,10,3,13,False,AAAAAAAAAHHHH,13
1385,888316277026172928,2017-07-21 08:34:39,5,2,7,False,AAAAAAHHHHHHHHHHHH,18
1386,888313760859004928,2017-07-21 08:24:39,5,1,6,False,AAAAAAAAAAAAAAAAAAAHH,21
1387,888311244389842945,2017-07-21 08:14:39,11,7,18,False,AAH,3
1388,888308727018909696,2017-07-21 08:04:39,11,5,16,False,AAAAAAAAAAAAAAAAAAHHHHHHHHHHHHHHH,33
1389,888306210327416832,2017-07-21 07:54:39,8,2,10,False,AAHHHHHHHH,10
1390,888303694198054912,2017-07-21 07:44:39,9,3,12,False,AAAAAAAAAAAAAAAAAH,18
1391,888301180056678401,2017-07-21 07:34:39,13,4,17,False,AAAAAAAAAAAAAAHHHHHHHHHHHHH,27
1392,888298659946868736,2017-07-21 07:24:38,21,11,32,False,AAAAAAAAAAAAAAAAAAAHHHHHHHHHHHHH,32
1393,888296146371833856,2017-07-21 07:14:39,7,7,14,False,AAAAAAAAAAAAAAAAAAAAAHHHHHHHHHHHHHHHH,37
1394,888293631207124992,2017-07-21 07:04:40,8,6,14,False,AAAAAAAAAAAAAAAAAAHHHHHHHHHHHHH,31
1395,888291111592054785,2017-07-21 06:54:39,6,3,9,False,AAAAAAH,7
1396,888288596578279424,2017-07-21 06:44:39,6,5,11,False,AAAAAAAAAAAAAAAAAAAAAAAHHHHHHHHHH,33
1397,888286078301421570,2017-07-21 06:34:39,7,2,9,False,AAHH,4
1398,888283561974874114,2017-07-21 06:24:39,8,2,10,False,AAAAAHHHHHHHHHHH,16
1399,888281045912526848,2017-07-21 06:14:39,12,4,16,False,AAAAAAAAAAAAAAHHHHHHHHHHHHHHH,29
1400,888279922971521025,2017-07-21 06:10:11,0,0,0,True,@Rudicron AAAAAAAAHHHHHH,24
1401,888278529355403265,2017-07-21 06:04:39,16,7,23,False,AAAAAAAAAAAAAAAAAAAAAHHHHHHH,28
1402,888276013716721665,2017-07-21 05:54:39,3,1,4,False,AAAAAH,6
1403,888274890813456384,2017-07-21 05:50:11,0,0,0,True,@bkgut3 AAAAAAAAAAAAHHHHHHHHHH,30
1404,888273495435526150,2017-07-21 05:44:39,14,4,18,False,AAAAAAAAAAAAAAAAAAAAAAAHHHHHHHHHHH,34
1405,888270979759198208,2017-07-21 05:34:39,19,11,30,False,AAAAAAAAAAAAAAAAAAAAAAAHHHHHHHH,31
1406,888268463273197568,2017-07-21 05:24:39,11,3,14,False,AAAHHHHHHHHHH,13
1407,888265947185684480,2017-07-21 05:14:39,2,1,3,False,AAAAAAAHHHHHHHHHHH,18
1408,888263429370150914,2017-07-21 05:04:39,13,5,18,False,AAAAAAAAAAAAAAAAAAAHHHHHHHHHHHHHHHH,35
1409,888260914566135809,2017-07-21 04:54:39,6,2,8,False,AAAAAAAAAAAAH,13
1410,888258396356362240,2017-07-21 04:44:39,7,2,9,False,AAAAAHHHHHHHHHHHH,17
1411,888255878939291648,2017-07-21 04:34:39,11,4,15,False,AAAAAAAAAAAAAAAAAAAAHHHHHHHHHHHHH,33
1412,888253364596752386,2017-07-21 04:24:39,10,1,11,False,AAH,3
1413,888250847007617025,2017-07-21 04:14:39,9,3,12,False,AAAAHHHHHHHHH,13
1414,888248459077197826,2017-07-21 04:05:10,0,0,0,True,@CatWomanResists AAAAAAAAAAAAAAAAAAAAHHHHH,42
1415,888248459072913408,2017-07-21 04:05:10,1,0,1,True,@blackwidows2017 AAAAAAAAAAAAAAAAAAAAAHHHHHHHHHHHHHH,52
1416,888248328797904897,2017-07-21 04:04:39,11,4,15,False,AAAAAAAAAAAAAAAAHHHH,20
1417,888245812454539264,2017-07-21 03:54:39,17,2,19,False,AAAAAAAAAAAAAAAAHHHHHHHHHHH,27
1418,888244688578166784,2017-07-21 03:50:11,0,0,0,True,@thejoaniemoser AAAAAAAAAAAAAAAAAAAHHHHHHHHHHH,46
1419,888243296673251328,2017-07-21 03:44:39,6,6,12,False,AAAHHHHHHHHHHHHHH,17
1420,888240779189080065,2017-07-21 03:34:39,13,7,20,False,AAAAAAAAAAHHHHHHHHHHH,21
1421,888238264204668928,2017-07-21 03:24:39,9,2,11,False,AHHHHHHHHH,10
1422,888235748578787328,2017-07-21 03:14:39,17,12,29,False,AAAAAAAAAAAAAAAAAAAAHHHH,24
1423,888233229907632128,2017-07-21 03:04:39,10,5,15,False,AAAAAAAAAHHHHHHHHHHHHH,22
1424,888230715485237248,2017-07-21 02:54:39,9,5,14,False,AAAAAAAAHHHHHHHHHHHHH,21
1425,888228195685814272,2017-07-21 02:44:38,8,1,9,False,AAAAAAAAAAAAAHHHHH,18
1426,888225680118489088,2017-07-21 02:34:39,7,2,9,False,AAAAHHHH,8
1427,888223165079592960,2017-07-21 02:24:39,14,2,16,False,AAAAHHHHHHHHHHHHHHH,19
1428,888220776738033664,2017-07-21 02:15:10,0,0,0,True,@word2art AAAAAAAAAAHHHHH,25
1429,888220776649953280,2017-07-21 02:15:10,3,0,3,True,@chelsearjones AAAAAAAAAAAAAAAAAAAAAAHHHHHHHHHHHH,49
1430,888220648077709312,2017-07-21 02:14:39,17,8,25,False,AAAAAAAAAAAAAAAAHHHHHHH,23
1431,888219524465647616,2017-07-21 02:10:11,0,0,0,True,@kristenwarner AAAAAAHHHHHHHHHHHHH,34
1432,888219524440498181,2017-07-21 02:10:11,1,0,1,True,@y2skt7 AAAAAAAAAHHHHHHHHHHHHHHHH,33
1433,888218130614550528,2017-07-21 02:04:39,18,13,31,False,AAAHHHHHH,9
1434,888217010366283776,2017-07-21 02:00:12,0,0,0,True,@word2art AHHHH,15
1435,888215743703257088,2017-07-21 01:55:10,2,0,2,True,@kristenwarner AAAAHHHHHHHH,27
1436,888215743699066880,2017-07-21 01:55:10,0,0,0,True,@MoBrisColo AAAAAAAAAAAAAAAAHHHHHHHHHHHHHHHH,44
1437,888215743690670080,2017-07-21 01:55:10,0,0,0,True,@camulus AAAAAAAAAAAAAHH,24
1438,888215612622864385,2017-07-21 01:54:38,12,6,18,False,AAHH,4
1439,888214490768187393,2017-07-21 01:50:11,0,0,0,True,@kristenwarner AAAAAAAAAAAAHHHHHHHHHHHHH,40
1440,888214490726182912,2017-07-21 01:50:11,0,0,0,True,@camulus AAAAAAHHHHHHHHHH,25
1441,888214490717794304,2017-07-21 01:50:11,0,0,0,True,@kristenwarner AAAAAAAAAAAAAHHHHHHHH,36
1442,888213227468935168,2017-07-21 01:45:10,0,0,0,True,@MrEAnders AAAAAAAAAAAAAHHHH,28
1443,888213227439616001,2017-07-21 01:45:10,0,0,0,True,@MrEAnders AAAAAAAAAAAAAAAAAAHHHHH,34
1444,888213096547921920,2017-07-21 01:44:39,11,2,13,False,AAAAAAAAAAHHHH,14
1445,888211972281577472,2017-07-21 01:40:11,3,0,3,True,@Ludology AAAHHHHHHHHHHHHHH,27
1446,888211972088639488,2017-07-21 01:40:10,0,0,0,True,@camulus AAAAAAAAAAAAAAAAAAHHHHHHHHHHHHHHHH,43
1447,888210711905751040,2017-07-21 01:35:10,0,0,0,True,@kristenwarner AAAAAAAHHHHHHHH,30
1448,888210583711035393,2017-07-21 01:34:39,8,4,12,False,AAAAAAAAAAAHHHHHHHHHH,21
1449,888208063672594432,2017-07-21 01:24:39,9,1,10,False,AAAAHHHHHHHHHH,14
1450,888205547643842560,2017-07-21 01:14:39,11,1,12,False,AAAAAAAAAHHHHHH,15
1451,888203035423494148,2017-07-21 01:04:40,5,2,7,False,AAAAAAAAAAAAAAAAAAAAAHHH,24
1452,888200514835537921,2017-07-21 00:54:39,9,5,14,False,AAAAAAAAAAHHHHHHHHH,19
1453,888197995929448449,2017-07-21 00:44:38,5,1,6,False,AAAAAAAAAAAAAHHHHHHHHHHH,24
1454,888195483382026240,2017-07-21 00:34:39,6,3,9,False,AAAAAAHHHHHH,12
1455,888192966602502148,2017-07-21 00:24:39,14,4,18,False,AAAAAAAAAAAAAAAAAAAAAAHHHHHHH,29
1456,888190450460504064,2017-07-21 00:14:39,7,5,12,False,AAAAAAAAAAAAAHHHHHHHHHHHHHH,27
1457,888188063993692162,2017-07-21 00:05:10,0,0,0,True,@bloodlesscoup AAAAAAHHHHHHHH,29
1458,888187933265731585,2017-07-21 00:04:39,3,5,8,False,AAHHHHHHHHHHHHHH,16
1459,888185414846214144,2017-07-20 23:54:39,8,9,17,False,AAAAAAAAAHHHHHHHHHHH,20
1460,888182899572445184,2017-07-20 23:44:39,15,3,18,False,AAAAAAAAAAAAAAAAAAAAHHHHHHHH,28
1461,888180382897713154,2017-07-20 23:34:39,19,9,28,False,AAAAAAAAAAAAAAAAAAAAAAHHHHHHHH,30
1462,888177996460429313,2017-07-20 23:25:10,0,0,0,True,@oldmeanroy AAAAAAAAAAAAAAAAHHHHHHHHHHHH,40
1463,888177865786896384,2017-07-20 23:24:39,5,3,8,False,AAAAAHH,7
1464,888175347543552000,2017-07-20 23:14:39,21,7,28,False,AAAAAAAAAAAAAAAAAAAAAAHHHHHHHHHHH,33
1465,888174223918858240,2017-07-20 23:10:11,0,0,0,True,@oldmeanroy AAAAAAAAAAAAAAAAAAAAHH,34
1466,888172963702472705,2017-07-20 23:05:10,0,0,0,True,@LilyMarsWrites AAAAAAAAAAAAAAAAAAAAHHHHHH,42
1467,888172831317667840,2017-07-20 23:04:39,5,2,7,False,AAAAAAAAAAAAAAHHHHHHH,21
1468,888170316769505282,2017-07-20 22:54:39,9,5,14,False,AAAAAAHHHHHHHHHHHHH,19
1469,888167797800546305,2017-07-20 22:44:39,10,8,18,False,AAAAAAAAAAAAAAAHHHHHHHHHHHHHHH,30
1470,888166674414931969,2017-07-20 22:40:11,1,0,1,True,@oldmeanroy AHHHHHHHHHHHHH,26
1471,888165283264909314,2017-07-20 22:34:39,7,1,8,False,AAAAAHHHHHH,11
1472,888162764476350464,2017-07-20 22:24:38,12,8,20,False,AAAAAAAAAHHHHHHHH,17
1473,888160250993442816,2017-07-20 22:14:39,8,5,13,False,AAAAAAAAAAAAAHHHHHH,19
1474,888157731756048385,2017-07-20 22:04:39,12,5,17,False,AAAAAAAAAAAAAAAAAAAAAHHHHHHHHHH,31
1475,888155214926270464,2017-07-20 21:54:39,10,2,12,False,AAAAAAAAAAAAAAAAHH,18
1476,888152698796879874,2017-07-20 21:44:39,13,7,20,False,AAAAAAAAAAAAAAAAAAAAAAHHHHHHHHHHHHHHH,37
1477,888150182986207232,2017-07-20 21:34:39,18,5,23,False,AAAAHHHHHHHHHHHHHH,18
1478,888147667993473025,2017-07-20 21:24:39,6,2,8,False,AAAAAAAAAHHHHHHH,16
1479,888145149271920640,2017-07-20 21:14:39,21,11,32,False,AAAAAAAAAAAAAAAAAAAAAAHHHHH,27
1480,888142634107187200,2017-07-20 21:04:39,12,5,17,False,AAAAAAAAAAAAAAAAHHH,19
1481,888141515452801024,2017-07-20 21:00:12,1,0,1,True,@ewsiii AAAHHHHHH,17
1482,888140248882053120,2017-07-20 20:55:10,0,0,0,True,@ewsiii AAAAAAAAAAAAAAAAAAAH,28
1483,888140248831623168,2017-07-20 20:55:10,0,0,0,True,@ewsiii AAAAAAAAAAAAAAAAHHHHHHHHHHHHH,37
1484,888140114643255298,2017-07-20 20:54:38,11,1,12,False,AAAAAAAAAAAHHHHHHH,18
1485,888138992503402497,2017-07-20 20:50:11,1,0,1,True,@ewsiii AAAAHHHHHHHHHHHHHHHH,28
1486,888138992239226881,2017-07-20 20:50:11,1,0,1,True,@ewsiii AHH,11
1487,888137602880217088,2017-07-20 20:44:39,12,1,13,False,AAAAHHHHHHHHHHHH,16
1488,888135083865014272,2017-07-20 20:34:39,18,11,29,False,AAAAAAAAAAAAAAAAAAAAAHHHHHHHHHHHH,33
1489,888133962337595392,2017-07-20 20:30:12,1,1,2,True,"@ewsiii AAAAAAAAAAAAAAAHHHHHHHHHHH 
https://t.co/FjuL4htOHg",59
1490,888133962324987908,2017-07-20 20:30:12,0,0,0,True,@cagedwanderlust AAAAAAAAAAAAAAAAHHHHHHHHH,42
1491,888132568595353600,2017-07-20 20:24:39,20,6,26,False,AAAAAAAAAAAAAAAAAAAAAAHHHHHHHHH,31
1492,888130050591031296,2017-07-20 20:14:39,9,4,13,False,AAAAAAHHHH,10
1493,888127665109991424,2017-07-20 20:05:10,0,0,0,True,@codenamehugs AAAAAAAAAAAAAAAAAAAAAAHHHHHHHHHHH,47
1494,888127535585910785,2017-07-20 20:04:39,6,2,8,False,AHHHHHHHHHH,11
1495,888126416331481089,2017-07-20 20:00:12,1,0,1,True,@jamandthat AAAAAAHHHH,22
1496,888125017254264832,2017-07-20 19:54:39,6,1,7,False,AAAAAHHH,8
1497,888122499119980544,2017-07-20 19:44:38,14,4,18,False,AAAAAAAAAAAAAAAAAAAAAHHH,24
1498,888119982403444736,2017-07-20 19:34:38,13,5,18,False,AAAAAAAAAAAAAAHHHHHHHHH,23
1499,888117466823483393,2017-07-20 19:24:39,5,3,8,False,AAAAAAAAAAAHHHH,15
1500,888116345245581313,2017-07-20 19:20:11,2,0,2,True,@WardQNormal AAAAAHHHHHH,24
1501,888114952619270145,2017-07-20 19:14:39,13,8,21,False,AAAAAAAAAAAAHHHHHHHHHHHHHH,26
1502,888113832664616964,2017-07-20 19:10:12,0,0,0,True,@ashicorn AAAAAAAAAAAAAAAAAAAAHHHHHHH,37
1503,888112569164079104,2017-07-20 19:05:11,0,0,0,True,@Outroupistache1 AAAAAAAAAAAAAAAAAAAHHHH,40
1504,888112436582137856,2017-07-20 19:04:39,12,6,18,False,AAAAAAAAAAAAAAAAAHHHHHHHHHHHHH,30
1505,888109917621465088,2017-07-20 18:54:39,6,7,13,False,AAHHHHHHHHHHHH,14
1506,888108794965708801,2017-07-20 18:50:11,0,0,0,True,@bethfiegerfalk AAAAAAAAAAAAAAAAHHHHHHHHHHHHHHH,47
1507,888107401232044032,2017-07-20 18:44:39,13,4,17,False,AAAAAAAHHHHHHHHH,16
1508,888104886012788736,2017-07-20 18:34:39,12,5,17,False,AAAAAAHHHHHHHHHHHHHH,20
1509,888102498778611713,2017-07-20 18:25:10,0,0,0,True,@michaelschwab13 AAAAAAAAAAAAAAAAAAAHHHHHH,42
1510,888102368855945216,2017-07-20 18:24:39,10,10,20,False,AAAAAAAAAAAAAAAAAAHHHHHH,24
1511,888099850847440898,2017-07-20 18:14:39,8,5,13,False,AAAAAAAAAAAHHHHHHHHHHHHHHH,26
1512,888097334197932036,2017-07-20 18:04:39,9,5,14,False,AAAAAAAAAAAAAAAAAAAAHHHHHHHHH,29
1513,888094817758191619,2017-07-20 17:54:39,9,4,13,False,AAAAAAAAAAAAAAAAAAHHHHHHHH,26
1514,888092433266987008,2017-07-20 17:45:10,0,0,0,True,@IceEmpress66 AAAAAAAAAAAAAAAAAAHHHHH,37
1515,888092303998562304,2017-07-20 17:44:39,11,7,18,False,AAAAAAAAAAAAAAAAHHHHHHHHHHHHHH,30
1516,888089786019348482,2017-07-20 17:34:39,4,2,6,False,"AAAAHHHHHHHHHHHHHHH 
https://t.co/h23hgBJBeD",44
1517,888087269407678464,2017-07-20 17:24:39,8,1,9,False,AAAAAAAAAAAAHH,14
1518,888084752170967041,2017-07-20 17:14:39,6,2,8,False,"AAAAAAAAAAAAAAAAAAAAHHHHHHH 
https://t.co/FjuL4htOHg",52
1519,888082235215237121,2017-07-20 17:04:39,6,2,8,False,AAAAAAAAAAAAHHHHHHHHHHHHH,25
1520,888079718297292800,2017-07-20 16:54:39,10,4,14,False,AAAAAAAAAAAAAAAAAAAAAHHHHHHHHHHHHH,34
1521,888078594412597248,2017-07-20 16:50:11,0,0,0,True,@MeghanPaulas AAAAAAAAAAAHHHHHHHHHHHHHH,39
1522,888077203124232192,2017-07-20 16:44:39,10,5,15,False,AAAAAAAAAAHHHHHHHHHHHHHHH,25
1523,888074685778460673,2017-07-20 16:34:39,12,2,14,False,AAAAAAAAAAAAAAAAHHHHHHHHHHH,27
1524,888072168881500162,2017-07-20 16:24:39,9,4,13,False,AAAAAAAAAAAAAAHHHHHHHHHHHHHHHH,30
1525,888069653142151168,2017-07-20 16:14:39,9,2,11,False,AAAAAAAAAAAAAAAAAAHHHHHHHHHHH,29
1526,888067137851588608,2017-07-20 16:04:39,10,4,14,False,AAHHHHHHHHHHHHHHHH,18
1527,888064621067849729,2017-07-20 15:54:39,11,1,12,False,AAAAAAAAAAAHHHHHHHHHHH,22
1528,888062102237261824,2017-07-20 15:44:39,18,4,22,False,AAAAAAAAAAAAHHHHHHHHHH,22
1529,888059586065969152,2017-07-20 15:34:39,7,2,9,False,AAAAAAAAAHHHHHHHHHH,19
1530,888057067977703424,2017-07-20 15:24:38,10,2,12,False,AAAAAAAAAAAAAHHHHHHHHHH,23
1531,888054551529521153,2017-07-20 15:14:38,7,1,8,False,AAAAAAAAAAAAAAAHHHHHHHHHHHHH,28
1532,888052038248140800,2017-07-20 15:04:39,8,6,14,False,AAAAAAAAAAAAAAAAAAAAAAAHHHHHHHHHHHHHHH,38
1533,888049518524203010,2017-07-20 14:54:39,6,3,9,False,AAAAAHHHHHHHHHHHHHHHH,21
1534,888047004009586688,2017-07-20 14:44:39,8,0,8,False,AHHHHHHHH,9
1535,888044488005955585,2017-07-20 14:34:39,7,4,11,False,AAHHHHHHHHHHHHH,15
1536,888042103854559232,2017-07-20 14:25:11,0,0,0,True,@Omniwaffle AAAAAAAAAAAAAAHHHHHHHH,34
1537,888042103711944704,2017-07-20 14:25:11,1,0,1,True,@fxnkls AAHHH,13
1538,888041970307878913,2017-07-20 14:24:39,6,0,6,False,AAAAHHHHHHH,11
1539,888039454442696704,2017-07-20 14:14:39,18,11,29,False,AAAAAAAAAAAAAAAAAAHHHHHHHHHHHHHHH,33
1540,888036939445788673,2017-07-20 14:04:39,22,11,33,False,AAAAAAAAAAAAAAAAAHHHHHHH,24
1541,888034421105885184,2017-07-20 13:54:39,7,0,7,False,AAAAAAAAHHHHHHHHHHHHHH,22
1542,888031905488277505,2017-07-20 13:44:39,3,0,3,False,AAAAAAAAAAAAAAAAAAHH,20
1543,888029519713624064,2017-07-20 13:35:10,1,0,1,True,@defectiveMom AAAAHH,20
1544,888029387827941376,2017-07-20 13:34:39,16,8,24,False,AAAAAAAAAAAAAAAAAAAAAAAHHHHHHHHHH,33
1545,888027000174243840,2017-07-20 13:25:10,0,0,0,True,@defectiveMom AAAAAAAHHHHHHHHHH,31
1546,888026871828541443,2017-07-20 13:24:39,9,2,11,False,AAAAAAAAAH,10
1547,888024355896217600,2017-07-20 13:14:39,6,3,9,False,AAAAAAAAAAAAAAAAAAAAAAHHHHHHHHHHHHH,35
1548,888021840945438720,2017-07-20 13:04:40,10,2,12,False,AAAAAAAAAAAAAAAAAAAAHHHHH,25
1549,888019319136931840,2017-07-20 12:54:38,6,0,6,False,AAAAAAAAAAAAAAAAAAHHHHHHHHHHHH,30
1550,888016807247872002,2017-07-20 12:44:40,5,0,5,False,AAAAAAAAHHHHHHHH,16
1551,888014290409709568,2017-07-20 12:34:39,8,1,9,False,AAAAAAAAH,9
1552,888011772279566337,2017-07-20 12:24:39,13,5,18,False,AAAAAAAAAAAAAHHHHHHHH,21
1553,888009254237601792,2017-07-20 12:14:39,11,4,15,False,AAAAAAAAAAAHHHHHHHHHH,21
1554,888006737189642240,2017-07-20 12:04:39,14,2,16,False,AAAAAAAAAAAAAAAAHHHHHHHHHHHHH,29
1555,888004223689994241,2017-07-20 11:54:39,11,3,14,False,AAAAAAAAAAAAAAAAAAAAHHHHHHHHHH,30
1556,888001704242933760,2017-07-20 11:44:39,6,9,15,False,AAAAAAAAAAAAAAAAAAAAAHHHHHHHHHHHHHH,35
1557,887999189690580993,2017-07-20 11:34:39,6,1,7,False,AAAAAAHHHHHHHHHHHHHHH,21
1558,887996670981668864,2017-07-20 11:24:39,9,1,10,False,AAAAAAAAAAAAAAAAHHHHHHHHHH,26
1559,887994288105283585,2017-07-20 11:15:11,0,0,0,True,@Space_X_Onion AAAAAAAAAAAAAAAAAAHHHH,37
1560,887994157012316165,2017-07-20 11:14:39,13,4,17,False,AAAAAAAAAAAAAAAAAAAAAHHHHH,26
1561,887991639809150976,2017-07-20 11:04:39,4,1,5,False,AAHHHHHHHHHHHHHH,16
1562,887989120802443264,2017-07-20 10:54:39,6,0,6,False,AAAAAAAAAHHHH,13
1563,887986607067996161,2017-07-20 10:44:39,10,2,12,False,AAAAAAAAAAAAAAAAAAAAAHHH,24
1564,887984088883359744,2017-07-20 10:34:39,4,1,5,False,AAAAAAAAAAAAAAAAAAAAAAHHHHHHHHHH,32
1565,887981573672402946,2017-07-20 10:24:39,3,3,6,False,AAAAAAAAAAAAAHHHH,17
1566,887979053713465345,2017-07-20 10:14:38,3,1,4,False,AHHHHHHHH,9
1567,887976538267942913,2017-07-20 10:04:39,12,4,16,False,AAAAAAAAAAAAAAAAAAAAHHHHHHH,27
1568,887974021354094592,2017-07-20 09:54:39,7,0,7,False,AAAAAAHHHHHHHHHHH,17
1569,887971506613039104,2017-07-20 09:44:39,7,0,7,False,AAAAAHHHHHHHHHHHH,17
1570,887968989732843522,2017-07-20 09:34:39,6,0,6,False,AAAAAAAAAAAAAAAHHHHHHH,22
1571,887966472533921792,2017-07-20 09:24:39,13,4,17,False,AAAAAAAAAAAAAHHHHHHHHHHHHHHHH,29
1572,887963955582427136,2017-07-20 09:14:39,3,0,3,False,AAAAAAAAAAAAAAAAAAHHHHHHHHH,27
1573,887961440954568704,2017-07-20 09:04:39,13,6,19,False,AAAAAAAAAAHHHHHHHHHHHHHHHH,26
1574,887958923008933888,2017-07-20 08:54:39,6,2,8,False,AAAAAAAAAAAAAAAAAAAAAHHHHHHHHH,30
1575,887956541416108032,2017-07-20 08:45:11,0,0,0,True,@heydonworks AAAAAAAAAAAHHHHHHHHHHHHH,37
1576,887956408800604160,2017-07-20 08:44:39,2,0,2,False,AAAAAAAAAAHHHHHHHHHHHHHH,24
1577,887953891563843584,2017-07-20 08:34:39,4,1,5,False,AAAAHHHHHHHHHH,14
1578,887951375606448128,2017-07-20 08:24:39,5,0,5,False,AAAAAAAAAAAAAAAAAAAAAAH,23
1579,887948856595447812,2017-07-20 08:14:39,8,7,15,False,AAAAAAAAAAAAAAAAAAAAHHHHHHHHHHHH,32
1580,887946339342069760,2017-07-20 08:04:39,5,2,7,False,AAAAAAAAAAHHHHHH,16
1581,887943956411166720,2017-07-20 07:55:11,0,0,0,True,"@JCharlie916 AH 
https://t.co/deNl6Na4DJ",40
1582,887943822948392961,2017-07-20 07:54:39,7,1,8,False,AAAAAHHHHHHHHHHHHH,18
1583,887941439623180289,2017-07-20 07:45:11,0,0,0,True,@TiredRandomWolf AAAAAAAAAAAAAAHHHHHHH,38
1584,887941306336649216,2017-07-20 07:44:39,7,0,7,False,AAAAAAAAAAAAAAAHHHHHHHHH,24
1585,887938792325345280,2017-07-20 07:34:39,15,8,23,False,AAAAAAAAAAAAAAAAAAAHHHH,23
1586,887936274719526914,2017-07-20 07:24:39,8,1,9,False,AAAAAAAAAHHHHHHHHHHHH,21
1587,887933759013650432,2017-07-20 07:14:39,3,1,4,False,AAAAAHH,7
1588,887931242712358912,2017-07-20 07:04:39,6,0,6,False,AAAAAAAAAAAHHHHHHHHHHHHHHHH,27
1589,887928723663712258,2017-07-20 06:54:39,10,3,13,False,AAAAAAAAAAAAAAAAAAHHHHHHHHHHHHHHHH,34
1590,887926206603177984,2017-07-20 06:44:39,7,0,7,False,AAAAAAAAAHHHHHHH,16
1591,887923691019018240,2017-07-20 06:34:39,15,5,20,False,AAAAAAAAHHHHHHHHH,17
1592,887921174042247168,2017-07-20 06:24:39,4,4,8,False,"AAAAAAAAAAAAAAAAAAAH 
https://t.co/cJJofLJO7W",45
1593,887918657921273856,2017-07-20 06:14:39,10,3,13,False,AAH,3
1594,887916141221478400,2017-07-20 06:04:39,5,1,6,False,AAAAAAAAAAAAAAHHH,17
1595,887913624685215744,2017-07-20 05:54:39,3,0,3,False,AAAAAAAAAAAAAAAAAAAAHHH,23
1596,887911106349592576,2017-07-20 05:44:39,5,0,5,False,AAAAAAHHHHHHHHHHHH,18
1597,887908591382011904,2017-07-20 05:34:39,7,1,8,False,AAAAAAAAAAHHHHHHHHHHH,21
1598,887907467384033280,2017-07-20 05:30:11,0,0,0,True,@RealGiantMeteor AAAAAAAAAAAAAAAAAAHHHHHHHH,43
1599,887906074371731456,2017-07-20 05:24:39,8,4,12,False,AAAAAAAAAAAAAAAAHHHHHH,22
1600,887903557319630848,2017-07-20 05:14:39,17,5,22,False,AAAAAAAAAAAAAAAAAHHHHHHHHHHHHHHHH,33
1601,887901041823547392,2017-07-20 05:04:39,16,0,16,False,"AAAAAAAAAAAHHHHHHH 
https://t.co/aofN6lUDJJ",43
1602,887898524511338496,2017-07-20 04:54:39,14,1,15,False,AAAAAAAAAAAAAAAAAAAAAAAHHHH,27
1603,887896007782141952,2017-07-20 04:44:39,13,1,14,False,AAAAAAAAAAAAAAHHHHHHHHHH,24
1604,887893493594685440,2017-07-20 04:34:39,8,1,9,False,AAAAHHHH,8
1605,887890976278286336,2017-07-20 04:24:39,12,7,19,False,AAAAAAAAAAAAAAAAAAAAAAHHHHHHHHH,31
1606,887888457636487168,2017-07-20 04:14:39,4,6,10,False,AAAAAAAAAAAAAHH,15
1607,887885944321445888,2017-07-20 04:04:39,24,10,34,False,AAAAAAAAAAAAAAAAAAAHHHHHHHHHHHHHH,33
1608,887883425637703685,2017-07-20 03:54:39,10,7,17,False,AAAAAAAAAAAAAAAHHH,18
1609,887880907302068228,2017-07-20 03:44:38,10,6,16,False,AAAAAAAAAAAAAAAAAHHHHHHHHH,26
1610,887878390207983617,2017-07-20 03:34:38,8,7,15,False,AAAAHHHHHHHHHHHH,16
1611,887875874158149633,2017-07-20 03:24:38,7,1,8,False,AAAAAAAAHHHHHH,14
1612,887873357999464448,2017-07-20 03:14:39,13,5,18,False,AAAAAAAAAAAAAAAHHHHHHHHHHHHHHHH,31
1613,887870840594980864,2017-07-20 03:04:38,13,6,19,False,AHHHHHHHHHHHHHHHH,17
1614,887868327254773761,2017-07-20 02:54:39,25,10,35,False,AAAAAAAAAAAAHHHHHHHHHH,22
1615,887865808499740672,2017-07-20 02:44:39,8,3,11,False,AAHHHHHHH,9
1616,887863293133684736,2017-07-20 02:34:39,10,6,16,False,AAAAAAAAAAAAAAAAAAAAAAAHHHHHHH,30
1617,887860776320589827,2017-07-20 02:24:39,7,3,10,False,AAAAAAAAAHHHHHHHHHH,19
1618,887858258257616897,2017-07-20 02:14:39,8,11,19,False,AAAAAAAAAAAAAAAAAAAHHH,22
1619,887855744753827840,2017-07-20 02:04:39,9,3,12,False,AAAAAAAAHHHHHHHHHHH,19
1620,887853227496136705,2017-07-20 01:54:39,15,5,20,False,AAAAAAAAAAAAAAAAAAAAAAHHHHHHHHHHH,33
1621,887852104106332163,2017-07-20 01:50:11,0,0,0,True,@susansabophoto AAAAAAAAAAAAAAAAAAAAHHH,39
1622,887850840752627712,2017-07-20 01:45:10,1,0,1,True,@Jurassic_paul AAAAAAAHHHHHHHH,30
1623,887850711517712384,2017-07-20 01:44:39,16,8,24,False,AAAAAAAAAAAAAAAAAAAAAAAHHHHHHHHHHHHH,36
1624,887849589210042368,2017-07-20 01:40:12,1,0,1,True,@dweomer AAAAAAAAAAAHHHHHHHHHHHHH,33
1625,887848193035296768,2017-07-20 01:34:39,15,13,28,False,AAAAAAAAAAAAAHHHHHHHHHHHHHH,27
1626,887845678940139520,2017-07-20 01:24:39,10,8,18,False,AAAAAAAAAAAAAAAAAAAHHHHHHHHHHH,30
1627,887844555307048965,2017-07-20 01:20:11,1,0,1,True,@susansabophoto AAAAAAAAAAAHHHHHH,33
1628,887843155856510977,2017-07-20 01:14:38,2,1,3,False,AAAHH,5
1629,887840645800439808,2017-07-20 01:04:39,3,2,5,False,AAAAAAAHHHH,11
1630,887838125866852352,2017-07-20 00:54:39,4,3,7,False,AAAAAAAAAAAAAHHHHHHHH,21
1631,887835610135834625,2017-07-20 00:44:39,11,10,21,False,AAAAAAAAAAAAAAAAAAHHHHHHHHHHH,29
1632,887833094610440193,2017-07-20 00:34:39,9,4,13,False,AAAAAAAAAAAAAAAAAAHHHHHHHHHHHH,30
1633,887830576543264769,2017-07-20 00:24:39,9,3,12,False,AAAAAAAAAHHHHHH,15
1634,887828061869232128,2017-07-20 00:14:39,7,0,7,False,AAAAAAAAAAHHHHHHHHHHHHH,23
1635,887825546582908929,2017-07-20 00:04:39,9,4,13,False,AAAAAAHHHHHHH,13
1636,887823029652381696,2017-07-19 23:54:39,13,9,22,False,AAAAAAAAAAAAAAAAAAAAHHHHHHHH,28
1637,887820509638995968,2017-07-19 23:44:39,7,5,12,False,AAAAAAAAAAAAAAAHHHHHHHHHHHHHHHH,31
1638,887817996223303680,2017-07-19 23:34:39,15,14,29,False,AAAAAAAAAAAAAAAAAAAAAAAHHHHHHHHHHHHHHHH,39
1639,887815479070535680,2017-07-19 23:24:39,8,1,9,False,AAAAHHHHHHHHH,13
1640,887814356351766528,2017-07-19 23:20:12,1,0,1,True,@sorrykb AAAAHHHHHHHHHHH,24
1641,887812961942818816,2017-07-19 23:14:39,5,0,5,False,AAAHHHH,7
1642,887810447470100480,2017-07-19 23:04:40,14,4,18,False,AAAAAAAAAAAHHHHHHHHHHHHHH,25
1643,887809330480914434,2017-07-19 23:00:13,0,0,0,True,@nadineayman_ AAAAAAAAAAAAHHHHHHHHHHHHHH,40
1644,887808059065737216,2017-07-19 22:55:10,2,0,2,True,@mattjmcclure AAAAAAAAAAAAAAAAAAAAAAHHHHHHHHHHH,47
1645,887807927016226816,2017-07-19 22:54:39,13,0,13,False,AAAAAAAAAAAAHHHHHHHHHHHHH,25
1646,887805409993666561,2017-07-19 22:44:39,11,6,17,False,AAAAAAAAAAAAAAHHHHHHH,21
1647,887802894161989633,2017-07-19 22:34:39,19,9,28,False,AAAAAAAAAAAAAAAAAAAHHHHHHHHHH,29
1648,887800507099742209,2017-07-19 22:25:10,1,0,1,True,@Zwergner AAAAAAAAAAHHHHHHHHHHHHHH,34
1649,887800378259013633,2017-07-19 22:24:39,4,2,6,False,AAAAAAAAAAAAAAAAAHHH,20
1650,887797861315948546,2017-07-19 22:14:39,9,6,15,False,AAAAAAAAAAAAAAAAAAAAAAAHHHHHHHHH,32
1651,887795347053043712,2017-07-19 22:04:39,6,2,8,False,AAAAAAAHHHHHH,13
1652,887792827111022594,2017-07-19 21:54:39,3,2,5,False,AAAAAAAAAAAAAAAAAAAAAAAHHHHHHHHHH,33
1653,887790311925317633,2017-07-19 21:44:39,7,3,10,False,AAAAAAAAAAAAAAAAH,17
1654,887787928138780672,2017-07-19 21:35:11,1,0,1,True,@lexica AAAAAAAAAAAAAAAAAAAAAHHHHHHHHHHHH,41
1655,887787796873785344,2017-07-19 21:34:39,7,1,8,False,AAAAAAAAAAAAAH,14
1656,887785277078503425,2017-07-19 21:24:38,14,4,18,False,AAAAAAAAAAAAAAAAAAAAAHHHHH,26
1657,887782761163083776,2017-07-19 21:14:39,12,6,18,False,AAAAAAAAAAAAAAAHHHHHHHHHHHHHHH,30
1658,887780244165406721,2017-07-19 21:04:39,14,5,19,False,AAAAAAAAAAAAAAAAAHHHHHHHHHHHH,29
1659,887777728283455488,2017-07-19 20:54:39,6,0,6,False,AAAAAAHHHHHHHH,14
1660,887775213420765186,2017-07-19 20:44:39,11,2,13,False,AAAAAAAAAAAAAHHHHHHHHHHHH,25
1661,887772694904700928,2017-07-19 20:34:39,13,2,15,False,AAAAAAAAAAAAAAAAAAAAAHHHHHH,27
1662,887770178179805184,2017-07-19 20:24:39,8,2,10,False,AAAAHHHHHHHH,12
1663,887767661400272896,2017-07-19 20:14:39,11,0,11,False,AAAAAAAAAAHHHHHHHHHHHHHHHH,26
1664,887765147808399364,2017-07-19 20:04:39,9,1,10,False,AAAAAAAAAAAAAAAAHHHHHHHHHHHHH,29
1665,887762631263703040,2017-07-19 19:54:39,10,1,11,False,AAAAAAAAAAAAAAAAAAHHHHHHHHHH,28
1666,887760115033571328,2017-07-19 19:44:39,7,1,8,False,AAAAAHHHHHHHHHHHHHHHH,21
1667,887757734250254337,2017-07-19 19:35:12,0,0,0,True,@unclegerg AAAAAAAAAAAAAAAAAAAAH,32
1668,887757596060471297,2017-07-19 19:34:39,13,2,15,False,AAAAAAAAAAAAAAAAAAAAAHHHHHHH,28
1669,887755082183397376,2017-07-19 19:24:39,8,0,8,False,AAAAAAAAAHHHHHHHHHHHHH,22
1670,887752694026440708,2017-07-19 19:15:10,0,0,0,True,@ewsiii AAAAAAAAAAAAAAAAAAAHHHHHH,33
1671,887752564737011712,2017-07-19 19:14:39,10,2,12,False,AAAAAAAAAAAAAAAAHHHH,20
1672,887750050029416450,2017-07-19 19:04:40,8,0,8,False,AAAAAAHHHHHHHHHHHHHHH,21
1673,887747530842398720,2017-07-19 18:54:39,8,3,11,False,AAAAAAAAAHHHHHHH,16
1674,887745012318031872,2017-07-19 18:44:39,7,1,8,False,AAAAAAAAAAAAAAAAAAAAAAAHHHHHHHHHHHH,35
1675,887742498688311296,2017-07-19 18:34:39,3,0,3,False,AAAAAAAHHHHHHHHHHHHHH,21
1676,887739979774001152,2017-07-19 18:24:39,7,1,8,False,AAAAAAAAAAAAAAAAAAHHHHHH,24
1677,887737462113677314,2017-07-19 18:14:38,7,0,7,False,AAHHHHHHHHHHHH,14
1678,887734949088034819,2017-07-19 18:04:39,10,5,15,False,AAAAAAAAAAHH,12
1679,887732429733195776,2017-07-19 17:54:39,6,2,8,False,AAAAAAHHHHHHHHH,15
1680,887729915336044556,2017-07-19 17:44:39,11,3,14,False,AAAAAAAAAAAAAAAHHHHHHHHHHHHHH,29
1681,887727397537275904,2017-07-19 17:34:39,5,2,7,False,AAAAAAAAAAAAAAAAAAAHHHHHHHH,27
1682,887724882594758656,2017-07-19 17:24:39,9,3,12,False,AAAAAAAAAAAAAAAHHHHHHH,22
1683,887722364330541056,2017-07-19 17:14:39,11,3,14,False,AAAAAAAAAAAAAAAAAAAAAAHHHHHHHHHHHHHHHH,38
1684,887719850247958534,2017-07-19 17:04:39,12,1,13,False,AAAAAAAAAAH,11
1685,887717464783638529,2017-07-19 16:55:11,0,0,0,True,@WellsiteGeo AAAAAAAAAAAAAAAAAAAAAAHHHHHHHHH,44
1686,887717330775670784,2017-07-19 16:54:39,7,2,9,False,AAAAAAAHHHHHHHHHHHH,19
1687,887714814587482112,2017-07-19 16:44:39,12,4,16,False,AAAAAAAAAAAAHHHHHHHHHHHH,24
1688,887712298407776256,2017-07-19 16:34:39,15,4,19,False,AAAAAAAAAAAAAAAAAAAHHHHHH,25
1689,887709783599525889,2017-07-19 16:24:39,10,1,11,False,AAAAAAHHHHHHHHHHHH,18
1690,887707265972801537,2017-07-19 16:14:39,14,5,19,False,AAAAAAAAAAAHHHHHHHHHHH,22
1691,887704880894398466,2017-07-19 16:05:11,0,0,0,True,@ChristOnABicycl AAAAAHHHHHHHHHHHHHHHH,38
1692,887704747519520769,2017-07-19 16:04:39,8,4,12,False,AAAAAAAAAAAAHHHHHHHHHHHHHHHH,28
1693,887703630605889537,2017-07-19 16:00:12,0,0,0,True,@WellsiteGeo AAAAAAAAAAAAAAAAAAAAAAHHHHHHH,42
1694,887702231235133440,2017-07-19 15:54:39,5,3,8,False,AAAAAAAAAAAAAHHHH,17
1695,887699715730657280,2017-07-19 15:44:39,10,4,14,False,AAAAAAAAAAAAAAAAAAAAAHHHHHHHHHHHHH,34
1696,887697199911534597,2017-07-19 15:34:39,4,0,4,False,AAAAAAHHHH,10
1697,887694812387954689,2017-07-19 15:25:10,0,0,0,True,@MattBachmann AAAAAAAAAAAAAAAAAHHHHHHHHHHHHHHHH,47
1698,887694682771292162,2017-07-19 15:24:39,5,3,8,False,AAAAAAAAAAHHHH,14
1699,887692166562291713,2017-07-19 15:14:39,12,3,15,False,AAAAAAAAAAAHHHHHHHH,19
1700,887691042388103168,2017-07-19 15:10:11,0,0,0,True,@Aiman_1_Gamer AAAAAAAAAHHHHHHHHHHHHH,37
1701,887689649854001153,2017-07-19 15:04:39,6,0,6,False,AAAAAAAHHH,10
1702,887687131056963585,2017-07-19 14:54:39,14,6,20,False,AAAAAAAAAHHHHHHHHHHHHHH,23
1703,887684615108001792,2017-07-19 14:44:39,17,8,25,False,AAAAAAAAAAAAAHHHHHHHHH,22
1704,887682097909026816,2017-07-19 14:34:39,9,1,10,False,AAAAAAAAAAAAAAAAAHHHH,21
1705,887679581406343168,2017-07-19 14:24:39,7,1,8,False,AAAHHHHH,8
1706,887677064660340738,2017-07-19 14:14:39,10,6,16,False,AAAAAAAAAAAAHHHHHHHHHH,22
1707,887674549868916737,2017-07-19 14:04:39,13,1,14,False,AAHHHHHHHHH,11
1708,887672030337880064,2017-07-19 13:54:38,8,2,10,False,AAHHHH,6
1709,887669514678280192,2017-07-19 13:44:39,9,0,9,False,AAAAAAAAAHHHHHHHHH,18
1710,887667130417762305,2017-07-19 13:35:10,0,0,0,True,@_DaisyPeel AAAAAAAAAAAAAAAAAAAAAAHHHHHHHHHHHHH,47
1711,887667000088162304,2017-07-19 13:34:39,9,4,13,False,AAAAAAAAAAAAAAAAAH,18
1712,887664613982179328,2017-07-19 13:25:10,1,0,1,True,@emmarhodes AAAAAAAAAAAAAAAAAAAAAAAHHHHHHHHHH,45
1713,887664481542844419,2017-07-19 13:24:39,7,1,8,False,AAAAAAAHHHHHHHHH,16
1714,887661965820256256,2017-07-19 13:14:39,7,4,11,False,AAAAHHHHHHHHHHH,15
1715,887659451985133568,2017-07-19 13:04:39,11,3,14,False,AAAAAAAAAAAAHHHHHHHH,20
1716,887658348119822336,2017-07-19 13:00:16,3,0,3,True,@SewertownNews AAAAAAAHHHHHHHHHHHHHHHH,38
1717,887656935738232833,2017-07-19 12:54:40,9,3,12,False,AAAAAAAAAAAAAAAAAAAAAAH,23
1718,887654417251610624,2017-07-19 12:44:39,11,7,18,False,AAAAAAAAAAAAAAAAAAAAAAAHHHHHHHHH,32
1719,887651898743980036,2017-07-19 12:34:39,6,1,7,False,AHHH,4
1720,887649384900571137,2017-07-19 12:24:39,4,0,4,False,AAAAAAAAAAAAAAAAAAAAH,21
1721,887646867395420160,2017-07-19 12:14:39,7,4,11,False,AAAAAAAAAAAAAAAAAAAAAHHHHHHHHHHHHHHHH,37
1722,887644353002393600,2017-07-19 12:04:40,5,2,7,False,AAAAAAAAAAAAHH,14
1723,887641833840553985,2017-07-19 11:54:39,12,3,15,False,AAAAAAAAAAAAHHHHHHHHHHHHHH,26
1724,887639316079546368,2017-07-19 11:44:39,14,9,23,False,AAAAAAAAAAAAAAAAAAAAAAAHHHHHHHHHHH,34
1725,887636799685881858,2017-07-19 11:34:39,8,3,11,False,AAAAAAAAAAAAAAAAAAHHHHH,23
1726,887634283791339520,2017-07-19 11:24:39,6,2,8,False,AAAAAAAAAAAAAAAAAHHHHHHHHH,26
1727,887631766307184640,2017-07-19 11:14:39,9,6,15,False,AAAAAAAAAAAAAAAAAAAAAAHHHHHHHHHHHH,34
1728,887630643580067840,2017-07-19 11:10:11,1,0,1,True,@plumenvahseh AAAAAAAAAAAAAAAAHHHHHHHHHHHHHH,44
1729,887629251070926848,2017-07-19 11:04:39,9,2,11,False,AAHHH,5
1730,887626732106338304,2017-07-19 10:54:38,7,2,9,False,AAAHHHHHHHHHHHHHHHH,19
1731,887624218384269317,2017-07-19 10:44:39,3,3,6,False,AAAAAAAAAAHHHHHHHHHH,20
1732,887621701000982528,2017-07-19 10:34:39,5,2,7,False,AAAAAAAAAAAAAAAHHHH,19
1733,887619186536710144,2017-07-19 10:24:39,8,7,15,False,AAAAAAAAAAAAAAAAAAAAAHHHHHHHHH,30
1734,887616667374714883,2017-07-19 10:14:39,3,0,3,False,AAAAAAAAAHHHHHHHH,17
1735,887614150985252864,2017-07-19 10:04:39,4,1,5,False,AHHHHHHHHHHHH,13
1736,887611635292090368,2017-07-19 09:54:39,3,0,3,False,AAAAAHHHHH,10
1737,887609118181265408,2017-07-19 09:44:39,5,3,8,False,AAAAAAAAAAAAAAAAAAAAHHHHHH,26
1738,887606601976352768,2017-07-19 09:34:39,4,0,4,False,AAAAAAAAAAAAAAAAAAAAAH,22
1739,887604083468754945,2017-07-19 09:24:39,10,3,13,False,AAAAAAAAAAAAAAAAAAAAHHHHHHHHH,29
1740,887601570816413696,2017-07-19 09:14:39,8,4,12,False,AAAAAAAAAAAAAAAAAAAAHHHHHHHHHHH,31
1741,887599051402817536,2017-07-19 09:04:39,3,0,3,False,AAHHHHHHHHHH,12
1742,887596534870806528,2017-07-19 08:54:39,5,1,6,False,AAAAAAAAAAAAAAAAAAHHHHHHH,25
1743,887594020469395456,2017-07-19 08:44:39,9,3,12,False,AAAAAAAHHHHHHHHHHH,18
1744,887591503446630401,2017-07-19 08:34:39,0,3,3,False,AAAAAAAAHH,10
1745,887588984196648961,2017-07-19 08:24:39,10,4,14,False,AAAAAAAAAAAAAAAAAAAAAHHHHHHHH,29
1746,887586468750925824,2017-07-19 08:14:39,3,1,4,False,AAAAAAAAAAAHHHHHHH,18
1747,887583953137414146,2017-07-19 08:04:39,2,0,2,False,AHHHHHHHHHH,11
1748,887581436953448449,2017-07-19 07:54:39,11,3,14,False,AAAAAAAAAAAAAAAAAHHHHH,22
1749,887578917984489473,2017-07-19 07:44:39,3,0,3,False,AAAAAAAAAAAAAAAHHHHHHHHH,24
1750,887576401477607424,2017-07-19 07:34:39,6,0,6,False,AAAHHHHHHHHHHHHH,16
1751,887573888661676032,2017-07-19 07:24:40,6,1,7,False,AAAAAAAAAAAAAAAAHHHHHHH,23
1752,887571369818566656,2017-07-19 07:14:39,4,4,8,False,AAAAAAAAHHH,11
1753,887568855316484096,2017-07-19 07:04:39,5,1,6,False,AAAAAAAAAAAAAAAAAAAAAAAHHHHH,28
1754,887566337295491072,2017-07-19 06:54:39,7,2,9,False,AAAAAAAAAAHHHHHHHHHHHHHHH,25
1755,887563818536140802,2017-07-19 06:44:39,6,2,8,False,AHHHH,5
1756,887561304281669632,2017-07-19 06:34:39,10,4,14,False,AAAAAAAAAAAAAHHHHHHHHHHHHHHH,28
1757,887560182229848065,2017-07-19 06:30:12,0,0,0,True,@auftrittssucht AAAAAAAAAAAAAAAAHHHHHHH,39
1758,887558786533208064,2017-07-19 06:24:39,4,1,5,False,AAAAAAAAAAAAAHHHHH,18
1759,887556267778220032,2017-07-19 06:14:38,5,4,9,False,AAAAAAAHHHHHHHHHHHHHH,21
1760,887553753771061248,2017-07-19 06:04:39,3,0,3,False,AAAAAAAAAAAAHHH,15
1761,887552632084148224,2017-07-19 06:00:12,1,0,1,True,@JCharlie916 AAAAAAAAAAAAAAAAAAHH,33
1762,887551239189385216,2017-07-19 05:54:39,14,3,17,False,AAAAAAAAAAAAAAAHHHHHHHHHHHHHHH,30
1763,887548721247932417,2017-07-19 05:44:39,8,1,9,False,AAAHHHHHHHHH,12
1764,887546204225253377,2017-07-19 05:34:39,9,1,10,False,AAAAAAAAAAAAAAAAAAAAAAHHHHHHHH,30
1765,887543689307983872,2017-07-19 05:24:39,4,1,5,False,AAAAAHHHHHHHHHHHH,17
1766,887541169516892160,2017-07-19 05:14:39,8,2,10,False,AAAAAAHHHHHHHHHHHHHH,20
1767,887538656373768193,2017-07-19 05:04:40,9,2,11,False,AAAAAAAAAAAAAAAAAAAAAAAH,24
1768,887536137581068288,2017-07-19 04:54:39,10,4,14,False,AAHHHHHHHHHHHHHHH,17
1769,887533619278995456,2017-07-19 04:44:39,10,6,16,False,AAAAAAHHHHHHHHHHHHHHHH,22
1770,887531102361014272,2017-07-19 04:34:38,7,2,9,False,AAAAAAHHHHHHH,13
1771,887528719262380032,2017-07-19 04:25:10,0,0,0,True,@hammer_handle AAAAAAAAAAAAAAAAAAHHHHHHHHHHHHHHHH,49
1772,887528587498323970,2017-07-19 04:24:39,8,1,9,False,AAAAAAHHHHHHHHHHH,17
1773,887527468298580000,2017-07-19 04:20:12,1,0,1,True,@Amber_Coffman AAHHHH,21
1774,887526200196964352,2017-07-19 04:15:10,1,0,1,True,@_Anunnery AHHHHHHHHHHHHHHHH,28
1775,887526071880613888,2017-07-19 04:14:39,18,4,22,False,AAAAAAAAAAHHHHHHHHHHHHHHHH,26
1776,887523554815770624,2017-07-19 04:04:39,29,16,45,False,AAAAAAAAAAAAAAAAAAAAHHHHHHHHHHHHHH,34
1777,887521037780430849,2017-07-19 03:54:39,7,1,8,False,AAAAAAAAAAAAAAAAAHHH,20
1778,887518519415406592,2017-07-19 03:44:38,9,4,13,False,AAAAAAAAAAAAHHHHHHHHHHH,23
1779,887516006180155392,2017-07-19 03:34:39,11,3,14,False,AAAAAAAAAHHH,12
1780,887513618945904641,2017-07-19 03:25:10,2,0,2,True,@mike_dory AHHHHHHHHHHHH,24
1781,887513487718719488,2017-07-19 03:24:39,16,7,23,False,AAAAAAAAAAAAAAAHHHHHHHHHHHHHH,29
1782,887510971023060992,2017-07-19 03:14:39,7,2,9,False,AAAAAAAAAAAH,12
1783,887508453786341376,2017-07-19 03:04:39,11,1,12,False,AAAAAAAAAAAAAAHHHHHHHHHHHH,26
1784,887505939426942980,2017-07-19 02:54:39,5,0,5,False,AAAAAAAAAAAAHHHHHHHHHHHHHHHH,28
1785,887503420051132417,2017-07-19 02:44:39,14,3,17,False,"AAAAHH 
https://t.co/cJJofLJO7W",31
1786,887500908241801216,2017-07-19 02:34:40,12,7,19,False,AAAAAAAAAAAAAAAAAAHHHHHHHHH,27
1787,887498389604249606,2017-07-19 02:24:39,10,1,11,False,AAAAAAAAHHHHHHHHHHHHHHHH,24
1788,887495872275259393,2017-07-19 02:14:39,8,3,11,False,AAAAAAAHHHH,11
1789,887493355084689408,2017-07-19 02:04:39,19,9,28,False,AAAAAAAAAAAAAAAHHHHHHHHHHHH,27
1790,887490839710228481,2017-07-19 01:54:39,11,4,15,False,AAAAAAAAAAAAAAAHHHHHHHHHH,25
1791,887488321630466051,2017-07-19 01:44:39,10,1,11,False,AAAAAAAAAAAAAAAHHHHHHHHHHHHH,28
1792,887487197456343040,2017-07-19 01:40:11,0,0,0,True,@PiggerPiggy AAAAAAAAAAAAAAAAAAAAAAH,36
1793,887485806239199232,2017-07-19 01:34:39,13,11,24,False,AAAAAAAAAAAAAAAAAAHHHHHHHHHHHHH,31
1794,887483423845167105,2017-07-19 01:25:11,0,0,0,True,@Ceannas AAAAAAAAH,18
1795,887483290277609473,2017-07-19 01:24:39,5,1,6,False,AAAAAAAAAAAAAHHHHHHH,20
1796,887482168225738753,2017-07-19 01:20:12,0,0,0,True,@Ceannas AAHHHHHHHHHH,21
1797,887480772713644034,2017-07-19 01:14:39,9,7,16,False,AAAAAAAAAHHHHHHH,16
1798,887478389149401088,2017-07-19 01:05:11,1,0,1,True,@Ceannas AAAAHHHHHHHH,21
1799,887478259469910016,2017-07-19 01:04:40,10,5,15,False,AAAAAAAAAAAAAAAAH,17
1800,887475738953355264,2017-07-19 00:54:39,8,0,8,False,AAAHHHHHHHHH,12
1801,887473223146905601,2017-07-19 00:44:39,10,1,11,False,AAAAAAAHHHHHHHHHHHH,19
1802,887472099408957440,2017-07-19 00:40:11,0,0,0,True,@Ceannas AAAAAAAAAAAAAAAAAAAHHHHHHHHHHHHHH,42
1803,887470838680883200,2017-07-19 00:35:11,0,0,0,True,@defectiveMom AAAAAAHH,22
1804,887470708254756865,2017-07-19 00:34:39,9,2,11,False,AAAHHH,6
1805,887469589327642626,2017-07-19 00:30:13,1,0,1,True,@Ceannas AAAAAAAAHHHHHHHHHHHHHHH,32
1806,887468191554949121,2017-07-19 00:24:39,10,2,12,False,AAAAAAAAAAAAHHHH,16
1807,887467066860736512,2017-07-19 00:20:11,1,0,1,True,@acslater00 AAAAAAAAAAAAAAAAAAAHHHHHHHHHHHHHH,45
1808,887465671034109952,2017-07-19 00:14:38,10,4,14,False,AAAAAAAAAAAAAAAAAAHHHHHHHHHHHHHHH,33
1809,887464546432163845,2017-07-19 00:10:10,0,0,0,True,@epiktistes AAAAAAAAAAHHHHHHHHHHH,33
1810,887463157572280320,2017-07-19 00:04:39,15,6,21,False,AAAAAAAAAAAAAAAAAAAHHHHHHHHHH,29
1811,887462038980657160,2017-07-19 00:00:12,0,0,0,True,@tee62 AAAAAHHHHHHHHHH,22
1812,887460638829809667,2017-07-18 23:54:39,24,18,42,False,AAAAAAAAAAAAAAAAAAAAAAHHHHHHHHHHHHHHHH,38
1813,887458123904147456,2017-07-18 23:44:39,17,4,21,False,AAAAAAAAAAAAHHHHHHHHHHHHHHH,27
1814,887455606768054273,2017-07-18 23:34:39,11,5,16,False,AAAAAAAAAAAAAAAAAAAAHHHHHHHHHHHHHHHH,36
1815,887453090227662848,2017-07-18 23:24:39,8,4,12,False,AAAAAAAAAAAAAAAAHHH,19
1816,887450573552984065,2017-07-18 23:14:39,7,7,14,False,AAAAAAAAAAAAAAHHHHHHH,21
1817,887448057406783489,2017-07-18 23:04:39,9,4,13,False,AAAAAAAAAAAAAAAAAAHHHHHHH,25
1818,887446941478596612,2017-07-18 23:00:13,1,1,2,True,@Dividist AAAAAAAHHHHHHH,24
1819,887445539717079042,2017-07-18 22:54:39,4,2,6,False,AAAAAAAAAAAHHHHH,16
1820,887444415110950912,2017-07-18 22:50:11,0,0,0,True,@nesliciim AAAAAAAAAAAAAAAAAAAHHHHHHHHHHHHHHH,45
1821,887443152398946304,2017-07-18 22:45:10,0,0,0,True,@nesliciim AAAAAAAAAAAAAAAAAAAAHHHHHH,37
1822,887443022530703360,2017-07-18 22:44:39,4,6,10,False,AAHHHHHHHHHHHHHH,16
1823,887440506569011201,2017-07-18 22:34:39,11,2,13,False,AAH,3
1824,887437992977104896,2017-07-18 22:24:39,4,4,8,False,AAAAAHHH,8
1825,887435608456650752,2017-07-18 22:15:11,0,0,0,True,@JudiSunshine AAAAAAAHHHHHHHHH,30
1826,887435472494092288,2017-07-18 22:14:39,4,2,6,False,AAAAAAAAAAAAAAAAAAHHHHHHHHHHHH,30
1827,887432957203554308,2017-07-18 22:04:39,11,10,21,False,AAAAAAAAAAAAAAAAAAAAAAAHHHHHHHHH,32
1828,887430440079982593,2017-07-18 21:54:39,16,5,21,False,AAAAAAAAAAAAAAAHHHHHHHHHHHHHHHH,31
1829,887427923489280002,2017-07-18 21:44:39,14,3,17,False,AAAAAAAAAAAAAHHHHHHHHH,22
1830,887425542328381441,2017-07-18 21:35:11,0,0,0,True,@sorrykb AAAAAAAAAAAAAAAAAAHHHHHH,33
1831,887425407812857858,2017-07-18 21:34:39,12,0,12,False,AAAAAAAAAAAAAHHHH,17
1832,887422891423391745,2017-07-18 21:24:39,8,0,8,False,AAAAAAAAAHHHHHHHHHH,19
1833,887420375545655298,2017-07-18 21:14:39,13,7,20,False,AAAAAAAAAAAAAAAAAAAAAHHHHHHHHHH,31
1834,887417858065670144,2017-07-18 21:04:39,8,8,16,False,AAAAAAAAAAAAAAAHHHHH,20
1835,887415342246580224,2017-07-18 20:54:39,8,4,12,False,AAAAAAAAAAAAAAAAAAAAHHHHHHHHHHHH,32
1836,887414218353496065,2017-07-18 20:50:11,0,0,0,True,@WellsiteGeo AAAAAH,19
1837,887412824699543552,2017-07-18 20:44:39,12,6,18,False,AAAAAAAAAAAAAAAAAAAAAAAHHHHHHH,30
1838,887410308842704896,2017-07-18 20:34:39,7,0,7,False,AAAAAAAHHH,10
1839,887407924208947207,2017-07-18 20:25:11,0,0,0,True,@MichaelZatylny AAAAAAAAAAAAHHHHH,33
1840,887407792298045440,2017-07-18 20:24:39,7,1,8,False,AAAAAAAAAAAHHHH,15
1841,887406670200135680,2017-07-18 20:20:12,0,0,0,True,@ewsiii AAAAAHHHHHHHHHHHHHHHH,29
1842,887405277074640897,2017-07-18 20:14:39,25,11,36,False,AH,2
1843,887402757438812160,2017-07-18 20:04:39,12,1,13,False,AAAAAAAAAAAAAAAAAAAAAHHH,24
1844,887400242517331970,2017-07-18 19:54:39,6,1,7,False,AAAAAAAHHHHHHHHHHHHH,20
1845,887399119354044417,2017-07-18 19:50:11,1,0,1,True,@ewsiii AAAAAAAAHHHHHHH,23
1846,887397725574234114,2017-07-18 19:44:39,8,2,10,False,AAAAAAAAAAAAAAAAAAAAAAHHHHHHHHHH,32
1847,887395340017688577,2017-07-18 19:35:10,0,0,0,True,@CeltThulhu AAAHHHHHHHH,23
1848,887395207792263168,2017-07-18 19:34:39,7,0,7,False,AAAH,4
1849,887394086331846658,2017-07-18 19:30:11,0,0,0,True,@ihatedeadends AAAAAAAAAAAAAAAHHHHHHHHHHHHH,43
1850,887392693235703809,2017-07-18 19:24:39,9,3,12,False,AAAAAAAAAAAAAAAAAAAHHHHHHHHHHHH,31
1851,887390175118192641,2017-07-18 19:14:39,11,2,13,False,AAAAAAAAAAAAAAAAAAAAAAAHHHHHHHH,31
1852,887387791042260992,2017-07-18 19:05:10,0,0,0,True,@Oryiuk AAAAAAAAHHHHHHH,23
1853,887387663107579907,2017-07-18 19:04:40,7,0,7,False,AHHHHHHHHHHHHH,14
1854,887386551226945536,2017-07-18 19:00:15,0,0,0,True,@AngelaV_13 AAAAAAAAAHHHHHH,27
1855,887385141236117507,2017-07-18 18:54:39,8,1,9,False,AAAAAAAAAAAAAAAAHHHHHHHH,24
1856,887382625710739456,2017-07-18 18:44:39,6,3,9,False,AAAAAAAAAAAAAAAAAAHHH,21
1857,887380110969589760,2017-07-18 18:34:39,9,5,14,False,AAAAAAAAAAAAAAAAAAAAAHHHHHHHHHHHH,33
1858,887377591790964736,2017-07-18 18:24:39,6,0,6,False,AAAAAAAAAAAAAAAAHHHHHHHHH,25
1859,887375077616099329,2017-07-18 18:14:39,8,1,9,False,AAAAAAAAAAAAAAHHHH,18
1860,887372558525452289,2017-07-18 18:04:39,14,2,16,False,AAAAAAAAAAAAAAAAAAAAAAAHHHH,27
1861,887370043406811136,2017-07-18 17:54:39,14,5,19,False,AAAAAAAAAAAAAAAAAAAAAAHHHHHHHHHHH,33
1862,887367528158199808,2017-07-18 17:44:39,17,5,22,False,AAAAAAAAAAAAAAAAAAAAHHHHHH,26
1863,887365010204352512,2017-07-18 17:34:39,11,0,11,False,AAAAAAAAAAAAAAAAHH,18
1864,887362493131218944,2017-07-18 17:24:39,14,3,17,False,AHHHHHHHHHHHHHHH,16
1865,887359977328967681,2017-07-18 17:14:39,9,8,17,False,AAAAAAAAAAAAAAAAHHHHHHHHHHH,27
1866,887357459412725761,2017-07-18 17:04:39,8,1,9,False,AAAAAAHHHHHHHHHH,16
1867,887355072207867905,2017-07-18 16:55:10,0,0,0,True,@DivSavel AAAAAAAAAAAAAAAAAAAHH,31
1868,887354940724830208,2017-07-18 16:54:38,4,1,5,False,AAAAAAAAAAAAAAAAAAAAAAAH,24
1869,887352558515359745,2017-07-18 16:45:10,1,1,2,True,@cschrader AAAAAAAAAAAAAAAAAAAAAAAHHHHHHHHHHHH,46
1870,887352416961798145,2017-07-18 16:44:37,8,1,9,False,AAAAAAAAAAAAHHH,15
1871,887349902661095424,2017-07-18 16:34:37,15,5,20,False,AAAAAAAAAAAAAAHHHHHHHHHHHHHH,28
1872,887348788423266311,2017-07-18 16:30:11,0,0,0,True,@PantherSherry AAAAAAAAAAAAAAAAAAAHHHHHHHHHH,44
1873,887347384522604544,2017-07-18 16:24:37,8,13,21,False,AAAAAAAAAAAAAAAAAAAAAAAHHHHHHHHHHHHHH,37
1874,887344870263844868,2017-07-18 16:14:37,12,1,13,False,AAAAAAAHHH,10
1875,887342355384340481,2017-07-18 16:04:38,11,3,14,False,AAAAAAAAAAAAAAAAAAAHHH,22
1876,887341245957365760,2017-07-18 16:00:13,0,0,0,True,@fasterthanlime AAAAAAAAAAAAAAAAAAH,35
1877,887339835295399937,2017-07-18 15:54:37,16,5,21,False,AAAAAAAAAAAAAAAAAAAAAAAHHH,26
1878,887337459876585473,2017-07-18 15:45:11,1,0,1,True,@camilareads AAAAAAAAHHHHHHHHHH,31
1879,887337319103070209,2017-07-18 15:44:37,11,3,14,False,AAAAAAAAAAAAAAAAAAAAAAAHHHHHHHHHHHH,35
1880,887334804773117952,2017-07-18 15:34:37,12,7,19,False,AAAAAAAAAAAAAAHHHHHH,20
1881,887332285464367104,2017-07-18 15:24:37,12,4,16,False,AAAAAAAAAAAAAHHHHHHHHHH,23
1882,887329771830509569,2017-07-18 15:14:38,9,4,13,False,AAAAAAAAAAAAAAAAHHHHH,21
1883,887327254371545089,2017-07-18 15:04:37,20,6,26,False,AAAAAAAAAAAAAAAAAAAAHHHHHHHH,28
1884,887324734999973893,2017-07-18 14:54:37,11,4,15,False,AAAAAAAAAAAAAAAAAAAAAAAHHHHHHHHHHHHH,36
1885,887322220422471680,2017-07-18 14:44:37,10,3,13,False,AAAAHHH,7
1886,887319703865229314,2017-07-18 14:34:37,13,2,15,False,AAAAAH,6
1887,887317185512833024,2017-07-18 14:24:37,8,1,9,False,AAAAAAAAAAHHHHHH,16
1888,887314669446234116,2017-07-18 14:14:37,13,6,19,False,AAAAAAAAAAAAAAAAAAAAAAAHHHHHHHHHHHHHHHH,39
1889,887312153631477760,2017-07-18 14:04:37,5,0,5,False,AAAAAAAAAAH,11
1890,887309776589385728,2017-07-18 13:55:10,0,0,0,True,@mattboydsmith AAAAAAAAAAAAAAAAAAAAAAHHH,40
1891,887309633941110784,2017-07-18 13:54:36,8,0,8,False,AAAAAAAAAAAHHHHHHHHHH,21
1892,887307119363534848,2017-07-18 13:44:37,19,12,31,False,AAAAAAAAAAAAAAAAAAAHHHHHHHHHHHHHHH,34
1893,887306005230620672,2017-07-18 13:40:11,0,0,0,True,@toits AAAAAAAAAAAAAAAHHHHHHHHHHHHHHHH,38
1894,887304603829751808,2017-07-18 13:34:37,14,3,17,False,AAAAAAAAAAAAAAAAAAAAH,21
1895,887302224766001156,2017-07-18 13:25:10,0,0,0,True,@cschrader AAAAAAHHHHHHHHHH,27
1896,887302087696101376,2017-07-18 13:24:37,12,6,18,False,AAAAAAAAAAAAAAAAAH,18
1897,887300973596725250,2017-07-18 13:20:12,0,0,0,True,@toits AAAAAAHHHHHHHHHH,23
1898,887299570702659584,2017-07-18 13:14:37,5,0,5,False,AAAAAAAAAAAHHHHHHH,18
1899,887298459132452865,2017-07-18 13:10:12,1,0,1,True,@cschrader AAAAAAAAAAHHHHHHHHHHHH,33
1900,887298458960396288,2017-07-18 13:10:12,0,0,0,True,@cschrader AAAAAAAHHHHHHHHHHHH,30
1901,887297057442201601,2017-07-18 13:04:38,3,0,3,False,AAAAHHHHH,9
1902,887294535042306048,2017-07-18 12:54:36,25,13,38,False,AAAAAAAAAAAAAAAAAHHHHH,22
1903,887292020716384257,2017-07-18 12:44:37,5,5,10,False,AAAHHHHHHHHHHHHH,16
1904,887289503936909314,2017-07-18 12:34:37,8,5,13,False,AAAAAAAAAAAAAAAAAAAAHHHHHH,26
1905,887286988625383425,2017-07-18 12:24:37,9,4,13,False,AAAAAAAAAAAAAAAAAAHHHHHHHHHHH,29
1906,887284469094387712,2017-07-18 12:14:37,10,2,12,False,AAAAAAAAAAAAAAAAHHHHHHHHHHHH,28
1907,887281954600734720,2017-07-18 12:04:37,10,0,10,False,AAAAAAAAAAAAH,13
1908,887279439645724673,2017-07-18 11:54:37,6,1,7,False,AAAAHHHHHHHH,12
1909,887276922459344897,2017-07-18 11:44:37,6,5,11,False,AAAAAAAAAAAAAAHHHHHHHHHHH,25
1910,887274404354379776,2017-07-18 11:34:37,6,2,8,False,AAAAAAAAAHHHHHHHH,17
1911,887271888816418816,2017-07-18 11:24:37,8,1,9,False,AAAAAAAAAAAAAAAAAAHHHH,22
1912,887269371738980352,2017-07-18 11:14:37,8,5,13,False,AAAAAAAAAAAAAAAAHHHHHHHHH,25
1913,887266856368820224,2017-07-18 11:04:37,3,0,3,False,AAAAAAHHH,9
1914,887264336800096256,2017-07-18 10:54:37,21,10,31,False,AAAAAAAAAAAAAAAHHHHHHHHHHHHHH,29
1915,887261821597618181,2017-07-18 10:44:37,5,1,6,False,AAAAAAHHHHHHHH,14
1916,887259296429461505,2017-07-18 10:34:35,8,3,11,False,AAAAAAAAAAAAAAAAAAAAAAHHHHHHHHHHHH,34
1917,887256779796688896,2017-07-18 10:24:35,4,2,6,False,AAHHHHHHHHHHHHHH,16
1918,887254260592803840,2017-07-18 10:14:34,4,3,7,False,AHHHHHHHHHHHHHH,15
1919,887251747344973824,2017-07-18 10:04:35,1,0,1,False,AAAAAAAAAAAAHHHHHHHHHHHHHHH,27
1920,887249227650408448,2017-07-18 09:54:34,2,0,2,False,AAAAHHHHHHHHH,13
1921,887246714352087040,2017-07-18 09:44:35,2,0,2,False,AAAAAAAAAAAHHH,14
1922,887244195358019584,2017-07-18 09:34:35,7,4,11,False,AAAAAAAAAAHHHHHHHHHHHH,22
1923,887241682646962176,2017-07-18 09:24:35,3,2,5,False,AAAAAAAAAAAAAHHHHHHHHHHHHHHHH,29
1924,887239163610791936,2017-07-18 09:14:35,3,2,5,False,AAAAAAAAAHHHHHHHHHHHHHHH,24
1925,887236646525169666,2017-07-18 09:04:35,4,3,7,False,AAAAAAAAAAAAAAAHHHH,19
1926,887235544509501440,2017-07-18 09:00:12,0,0,0,True,@the_turtle AAAAHHHHHHH,23
1927,887234134028034049,2017-07-18 08:54:36,5,2,7,False,AAAAAHHHHHH,11
1928,887231762279124992,2017-07-18 08:45:10,0,0,0,True,@ThatOneLuna AAAAAAAAAAAAAH,27
1929,887231611846176768,2017-07-18 08:44:34,1,2,3,False,AAAAAAAAAAAAAHHHHHHHHH,22
1930,887230507070750721,2017-07-18 08:40:11,0,0,0,True,@the_turtle AAAHHHHH,20
1931,887230507066511361,2017-07-18 08:40:11,0,0,0,True,@LaTinifromRL AAAAAAAAHH,24
1932,887229245939998721,2017-07-18 08:35:10,0,0,0,True,@the_turtle AAAAAAAAAAAAAAAAAAHHH,33
1933,887229095615975424,2017-07-18 08:34:34,5,4,9,False,AHHHHHHHHHHH,12
1934,887227988802187264,2017-07-18 08:30:11,0,0,0,True,@the_turtle AAAAAAAAAAAAAHHHHH,30
1935,887226729584111616,2017-07-18 08:25:10,0,0,0,True,@LaTinifromRL AAHHHHHHH,23
1936,887226581525176323,2017-07-18 08:24:35,2,2,4,False,AAHHH,5
1937,887224065655746560,2017-07-18 08:14:35,6,2,8,False,AAAAAAAAAAAAAAAAAHHHHHH,23
1938,887221545973809152,2017-07-18 08:04:34,5,1,6,False,AAAAAAAAAAAHH,13
1939,887219031622787074,2017-07-18 07:54:35,5,3,8,False,AAAAAAAAAAAAAAAHH,17
1940,887216516386746368,2017-07-18 07:44:35,5,2,7,False,AAAAAHHHHHHHHHH,15
1941,887213996398583808,2017-07-18 07:34:35,6,3,9,False,AAAAAAAAAAAAHHHHHHHHHHHH,24
1942,887211483259711488,2017-07-18 07:24:35,7,2,9,False,AAAHHHH,7
1943,887208964798238720,2017-07-18 07:14:35,10,2,12,False,AAAAAAAAAAAAAAAAAAAAAHHHHHHH,28
1944,887207857292267520,2017-07-18 07:10:11,0,0,0,True,@LeonsDepot AAAAAAAAAAHHHHHHHH,30
1945,887206449314754560,2017-07-18 07:04:35,5,3,8,False,AAAAAAAAAAAAAAAHHHHHHHHHHHHHHH,30
1946,887203930547130369,2017-07-18 06:54:35,13,3,16,False,AAAAAAAAAAAAAAAAAAHHHHHHHHHH,28
1947,887201416695230464,2017-07-18 06:44:35,9,3,12,False,AAAAAAAAAAAAAAAAAAAAAAAH,24
1948,887198900507086848,2017-07-18 06:34:35,6,1,7,False,AAAAAAAAAHHHHHH,15
1949,887196380023971840,2017-07-18 06:24:34,11,3,14,False,AAAAAAAAAAAAHHHHHHHHHHHHHH,26
1950,887193864896995328,2017-07-18 06:14:35,5,2,7,False,AHHHHHHHHHH,11
1951,887191346179706880,2017-07-18 06:04:34,6,2,8,False,AAAAAAAAAAHHHHHHH,17
1952,887188833539903490,2017-07-18 05:54:35,8,3,11,False,AAAAAAAAAAAAAAAAAHHHHHHHHHHH,28
1953,887187727267115009,2017-07-18 05:50:11,0,0,0,True,@WalkerFoley AAAAAAAAAAAAAAAHHHHHHH,35
1954,887186313170087936,2017-07-18 05:44:34,15,4,19,False,AAAAAAAAAAAAAAAAAAAAAAHHHHHHH,29
1955,887183796591882240,2017-07-18 05:34:34,15,9,24,False,AAAAAAAAAAAAAAAAAAAAAAHHHHHHHHHHH,33
1956,887181283226472449,2017-07-18 05:24:35,8,4,12,False,AAHHHHHHHHHHHH,14
1957,887178767239593984,2017-07-18 05:14:35,3,0,3,False,AAAAH,5
1958,887176248044261376,2017-07-18 05:04:35,9,2,11,False,AAAAAAAAAAAAAAAAAAH,19
1959,887173733617684480,2017-07-18 04:54:35,7,0,7,False,AAAAAAAAAAAAAAHHH,17
1960,887171215261040640,2017-07-18 04:44:35,11,5,16,False,AAAH,4
1961,887168698020245504,2017-07-18 04:34:35,5,5,10,False,AAAAAAHHHHHHHHHHHHHHHH,22
1962,887166181710417925,2017-07-18 04:24:35,2,0,2,False,AAAAAAAAHH,10
1963,887163664993849344,2017-07-18 04:14:35,6,4,10,False,AAHHHHHH,8
1964,887161296805916672,2017-07-18 04:05:10,0,0,0,True,@Dzigavertovv AAAAAAAAAAAAAAAAAHHHHHHHHH,40
1965,887161150789603328,2017-07-18 04:04:35,7,4,11,False,AAAAAAAAAAAAAAAAAAAAAAHHHHHHHHHH,32
1966,887160045003210752,2017-07-18 04:00:12,1,0,1,True,@Dzigavertovv AAAHH,19
1967,887158631606734848,2017-07-18 03:54:35,7,3,10,False,AAAHHHHHHH,10
1968,887156115540242432,2017-07-18 03:44:35,6,2,8,False,AAAAAAAAAAAAAAAAAAHH,20
1969,887153600417411072,2017-07-18 03:34:35,8,2,10,False,AAAAAAAAHHHH,12
1970,887151082299949056,2017-07-18 03:24:35,4,1,5,False,AAAAHHHHHHHHHHH,15
1971,887148567579828224,2017-07-18 03:14:35,12,6,18,False,AAAAAAAAAAAAAAAHHHHHHHHHHH,26
1972,887146048669536257,2017-07-18 03:04:35,12,4,16,False,AAAAAAAAAAAAAAHHHHHHHHH,23
1973,887143534490472448,2017-07-18 02:54:35,7,4,11,False,AAAAAAAAAAHHHHHHHHHH,20
1974,887141016985325568,2017-07-18 02:44:35,12,1,13,False,AAAAAHHHHHHHHHHHHHHHH,21
1975,887138501342498817,2017-07-18 02:34:35,7,2,9,False,AAAAAAAAAAAHHHHHHHHHHHHH,24
1976,887136132185632768,2017-07-18 02:25:10,0,0,0,True,@TwinsieBlue07 AAAAAAHHHHHHHHH,30
1977,887135983564722177,2017-07-18 02:24:35,10,1,11,False,AAAAAAHHHHHHHHHHH,17
1978,887133467800215552,2017-07-18 02:14:35,8,1,9,False,AAAAAAAAHHHHH,13
1979,887131096365891584,2017-07-18 02:05:10,0,0,0,True,@defectiveMom AAHHHHHH,22
1980,887130952429973504,2017-07-18 02:04:35,12,2,14,False,AAAAAAAAAAAAAHHHHHHHHHHH,24
1981,887128435671408640,2017-07-18 01:54:35,22,13,35,False,AAAAAAAAAAAAAAAAAAAAAAHHHHHHHH,30
1982,887125917176410116,2017-07-18 01:44:35,19,9,28,False,AAAAAAAAAAAAAAAAHHH,19
1983,887123398954016768,2017-07-18 01:34:34,18,11,29,False,AAAAAAAAAAAAAAAAAAAAAAHHHHHHHHHHHHHHH,37
1984,887120883755732994,2017-07-18 01:24:35,12,2,14,False,AAAAAAAAHHHHHHHHHHHHHH,22
1985,887118369614430208,2017-07-18 01:14:35,16,3,19,False,AAAAAAAAAAAAAAAAAAAH,20
1986,887115852943941634,2017-07-18 01:04:35,11,2,13,False,AAAHHHHHHHHH,12
1987,887113479848701952,2017-07-18 00:55:10,0,0,0,True,@melissawiebe AAAAAAAAAAAAAAAAAAAAHHHH,38
1988,887113479689297920,2017-07-18 00:55:09,0,0,0,True,@BeaverNaughty AAHHHHHHH,24
1989,887113336260841476,2017-07-18 00:54:35,12,3,15,False,AAAAAAAAAAAAAAAAHHHHHHHHHHHHHHH,31
1990,887112228238917633,2017-07-18 00:50:11,0,0,0,True,@BeaverNaughty AAAAAAAAHHHHHHHHHHHHHHHH,39
1991,887110966282002433,2017-07-18 00:45:10,0,0,0,True,@BeaverNaughty AHHHHH,21
1992,887110818025832449,2017-07-18 00:44:35,13,6,19,False,AAAAAAAAAAAAAAAAAAAHHHHHHHHHHHH,31
1993,887108302257238017,2017-07-18 00:34:35,22,14,36,False,AAAAAAAAAAAHHHHHHHHHHHHHH,25
1994,887107196257001475,2017-07-18 00:30:11,0,0,0,True,@ConcernedLefty AAAAAH,22
1995,887105784601079808,2017-07-18 00:24:35,13,5,18,False,AAAAAAAAAAAAHHHHHH,18
1996,887104677187399680,2017-07-18 00:20:11,0,0,0,True,@MichaelGately3 AAHHHHHHHHHHHHH,31
1997,887103267695624193,2017-07-18 00:14:35,17,5,22,False,AAAAAAAAAAAAAAAAAAAAHHHHHHHHHHH,31
1998,887100899654500354,2017-07-18 00:05:10,2,0,2,True,@joshu AHHHH,12
1999,887100750219890689,2017-07-18 00:04:35,22,10,32,False,AAAAAAAAAAAAAAAAAAAAAHHHHHH,27
2000,887098234979721216,2017-07-17 23:54:35,5,6,11,False,AAAAAAAAAAHHHHHHHHHHH,21
2001,887095717864628229,2017-07-17 23:44:35,6,4,10,False,AAAHH,5
2002,887093195619913728,2017-07-17 23:34:33,25,11,36,False,AAAAAAAAAAAAAAAAHHHHHHHHHHHHHH,30
2003,887090676525125632,2017-07-17 23:24:33,13,8,21,False,AAAAAAAAAAAAAAAAAAAAAAAHHHHHHHH,31
2004,887088161930784768,2017-07-17 23:14:33,7,1,8,False,AAAAAAAAAAAAHHHHHHHH,20
2005,887085643897196544,2017-07-17 23:04:33,18,15,33,False,AAAAAAAAAAAAAAAAAAAHHHHHHHHH,28
2006,887084548445663232,2017-07-17 23:00:12,0,0,0,True,@TiredRandomWolf AAAAHHHHHH,27
2007,887083125272182784,2017-07-17 22:54:32,10,4,14,False,AAAAAAAAHHHHHHHHHHHH,20
2008,887080610774355973,2017-07-17 22:44:33,7,2,9,False,AAAAAAAHHHHHHHH,15
2009,887078095353761793,2017-07-17 22:34:33,10,6,16,False,AAAAAAAAAAAAAAAAAAAAAAHHHHHHHHHHHHHHH,37
2010,887075731762819072,2017-07-17 22:25:10,1,0,1,True,@Lauremari2 AAAHHHH,19
2011,887075578314182660,2017-07-17 22:24:33,2,2,4,False,AAAAAAAAAAAAAHH,15
2012,887073062688096257,2017-07-17 22:14:33,8,4,12,False,AAAAAAAAAAAAAAAHHH,18
2013,887070544838963200,2017-07-17 22:04:33,5,2,7,False,AAAAAAAAAAAAAAHH,16
2014,887069449362317313,2017-07-17 22:00:12,0,0,0,True,@jbono AAAAAAAAAAAAAAAAHHHHHHH,30
2015,887068184288915457,2017-07-17 21:55:10,10,0,10,True,@Cruithintuait AAAAAAAAAAAAAAAAAAAAAHHHHHHHHHHHHHHHH,52
2016,887068026788618242,2017-07-17 21:54:33,3,0,3,False,AAHHHHHHHHHHH,13
2017,887065520666808320,2017-07-17 21:44:35,7,8,15,False,AAAAAAAAAAAAAAAAAAAHHHHHH,25
2018,887063002561773568,2017-07-17 21:34:35,7,3,10,False,AAAAHHHH,8
2019,887061895936704512,2017-07-17 21:30:11,1,0,1,True,@PantherSherry AAAAAAAAAAAAAAAHHHHHHHHH,39
2020,887061895903051780,2017-07-17 21:30:11,2,0,2,True,@PantherSherry AAAAAAAAAAAAHHHHHHHHHH,37
2021,887061895840235520,2017-07-17 21:30:11,0,0,0,True,@steellt78 AAHHHHHHHHHHHH,25
2022,887060632473935872,2017-07-17 21:25:10,5,0,5,True,@PantherSherry AAAAAAAAAAAAAAAAAAAAAAAHHHHHHHHH,47
2023,887060632452960258,2017-07-17 21:25:10,7,0,7,True,@PantherSherry AAAAAAAAH,24
2024,887060632448753669,2017-07-17 21:25:10,2,0,2,True,@PantherSherry AAAAAHHH,23
2025,887060632444575745,2017-07-17 21:25:10,0,0,0,True,@Hiwayman116 AAAAAAAAAAAAAAAAAAAAAHHHH,38
2026,887060485585199104,2017-07-17 21:24:35,19,15,34,False,AAAAAAAAAAAAAAAAAAAHHHHHHHHHHHHHHH,34
2027,887058118336811008,2017-07-17 21:15:10,0,0,0,True,@Eisinthewater AAHHHHHHHHHHH,28
2028,887057970953154560,2017-07-17 21:14:35,10,2,12,False,AAAAAAAAAAAAAAAAAHHHH,21
2029,887055600995233794,2017-07-17 21:05:10,45,0,45,True,@JMad414 AAAHHHHHHHHH,21
2030,887055455700307969,2017-07-17 21:04:35,7,2,9,False,AAAAAHHHHHHHHHHHHH,18
2031,887052937092112385,2017-07-17 20:54:35,21,9,30,False,AAAAAAAAAAAAAAHHHHHHHHHHHHHH,28
2032,887051829770674176,2017-07-17 20:50:11,80,0,80,True,@jsbalek AAAAAAAAAAAAAAAAAAAAAHHHHH,35
2033,887050566056194052,2017-07-17 20:45:10,172,2,174,True,@jsbalek AAAAAAAAAAAAAAAHHHHHHHHHHHHHHH,39
2034,887050418106380288,2017-07-17 20:44:34,13,3,16,False,AAAAAAHHHH,10
2035,887049310646489090,2017-07-17 20:40:10,1,0,1,True,@PonderinPothead AAAAAAAAAAAAAAAAAAAAAAAHHHHHHHHHHH,51
2036,887047904204120065,2017-07-17 20:34:35,14,2,16,False,AAAAAAAAAAHHH,13
2037,887045386577350657,2017-07-17 20:24:35,17,4,21,False,AAAAAAAHH,9
2038,887042868694704128,2017-07-17 20:14:35,7,3,10,False,AAAAAAHH,8
2039,887040356247797760,2017-07-17 20:04:35,12,5,17,False,AAAAAAAAAAAAAAAAAAAAAHHHHHHHHH,30
2040,887037987787329541,2017-07-17 19:55:11,0,0,0,True,@THuelskoetter AAAAAAAAAAAAAAAAAAAAAAAHHHHHHHHHHHH,50
2041,887037836767186944,2017-07-17 19:54:35,17,8,25,False,AAAAAAAAAAAAAAAAAHHHHH,22
2042,887036734747422720,2017-07-17 19:50:12,1,0,1,True,@keepyalifeyours AAAAAAHHHHHHHHHH,33
2043,887036734353100800,2017-07-17 19:50:12,1,0,1,True,@THuelskoetter AAAAAAAAAAAAAAAAHHHHHHHHHHHHHHHH,47
2044,887035322076364800,2017-07-17 19:44:35,7,2,9,False,AAAAAAAAAAAAAAAAAAHHHHHHHH,26
2045,887032953334845440,2017-07-17 19:35:11,1,0,1,True,@keepyalifeyours AAAAAAAAAAAAAAAAHH,35
2046,887032803442868224,2017-07-17 19:34:35,20,9,29,False,AAAAAAAAAAAAAAAAAAAAAAAHHHHHHH,30
2047,887030286642556928,2017-07-17 19:24:35,12,3,15,False,AAAAAAAAHHHHHHHH,16
2048,887027770295021570,2017-07-17 19:14:35,12,5,17,False,AAAAAAAAAAAAHHHHHHHHHHHHHHH,27
2049,887025257374154753,2017-07-17 19:04:36,6,2,8,False,AAAAHHHHHH,10
2050,887022738183004161,2017-07-17 18:54:35,10,5,15,False,AAAAAAAAHHHHHHHHHHHHHHHH,24
2051,887020222372352000,2017-07-17 18:44:35,7,2,9,False,AAAAAAAAAAAAAAAHHHH,19
2052,887017703105593348,2017-07-17 18:34:35,8,2,10,False,AAAAAHHHHHHHHH,14
2053,887015189173985282,2017-07-17 18:24:35,9,5,14,False,AAAAAAAAAAAAAAAAHHHHHHH,23
2054,887012671928901632,2017-07-17 18:14:35,7,0,7,False,AAAAAAAAAHHHHHHHHHHHHHHH,24
2055,887010156193755137,2017-07-17 18:04:35,11,0,11,False,AAAAAAAAAAAAAAAAAAAHHHHHHHHHHH,30
2056,887007640131383296,2017-07-17 17:54:35,8,0,8,False,AAAAAAAAAAAAAHHH,16
2057,887005121208623104,2017-07-17 17:44:35,14,4,18,False,AAAAAAAAAAAAAAAAAHHHHHHHHHHHH,29
2058,887002606983401473,2017-07-17 17:34:35,13,3,16,False,AAAAAAAAAAAAAAAAAAHHHHHHHHHHHHHHHH,34
2059,887000087565676544,2017-07-17 17:24:35,10,4,14,False,AAAAAAAAAAAAHHHHH,17
2060,886997574019887106,2017-07-17 17:14:35,11,2,13,False,AAAAAAHHHHHHHH,14
2061,886995055470419968,2017-07-17 17:04:35,17,4,21,False,AAAAAAAAAAAAAAAAAAAAHHHHHHHHHHHH,32
2062,886992537352888325,2017-07-17 16:54:35,9,1,10,False,AAAAAAAAAAAHHHHHHH,18
2063,886990021596729345,2017-07-17 16:44:35,10,1,11,False,AAAAHHH,7
2064,886988914459906048,2017-07-17 16:40:11,1,0,1,True,@thomascmost AAAAAAAAAAHHHHHHHHHHHHHHHH,39
2065,886987505177907200,2017-07-17 16:34:35,6,0,6,False,AAAAAAAAH,9
2066,886984990956933120,2017-07-17 16:24:35,10,2,12,False,AAHHHHHHHHHHHHHHH,17
2067,886982462940860417,2017-07-17 16:14:33,9,2,11,False,AAAAAAAAAAAAAAAAAAAHHHHHHHHHH,29
2068,886979947943874561,2017-07-17 16:04:33,16,4,20,False,AAAAAAAAAAAAAAHHHHHHHHHHHHH,27
2069,886977432397500418,2017-07-17 15:54:33,8,0,8,False,AAAAAAHHHHHHHHHH,16
2070,886974913768292352,2017-07-17 15:44:33,9,0,9,False,AAAAAAAAAAHHHHHHHHHHHHHH,24
2071,886972397483679744,2017-07-17 15:34:33,9,1,10,False,"AAAAAAAAAAHHHHHH 
https://t.co/cJJofLJO7W",41
2072,886971300811558912,2017-07-17 15:30:11,1,1,2,True,@hall_mackey AAAAAAAAAAAAAAAAAAAAAAH,36
2073,886969879936589824,2017-07-17 15:24:33,13,5,18,False,AAAAAAAAAAAAAAAAHHHHHH,22
2074,886967365698813952,2017-07-17 15:14:33,17,2,19,False,AAAAAAAAAAAAAAAAAAAAAAAHHHHH,28
2075,886964849816817664,2017-07-17 15:04:33,10,1,11,False,AAHHHHHHH,9
2076,886962332110336001,2017-07-17 14:54:33,11,2,13,False,AAAAAAAAAAAAAAAAAAHHHHHHHHHHHH,30
2077,886959816027115520,2017-07-17 14:44:33,3,1,4,False,"AAHHHHHHHHH 
https://t.co/cJJofLJO7W",36
2078,886957297137790976,2017-07-17 14:34:33,9,2,11,False,AAAAAAAH,8
2079,886956198855147521,2017-07-17 14:30:11,1,0,1,True,@defectiveMom AAAAAAAAAAAAAAAAHHH,33
2080,886954780719013889,2017-07-17 14:24:33,11,1,12,False,AAHHHHH,7
2081,886952264463679489,2017-07-17 14:14:33,12,1,13,False,AAAAAAAAAAAAAAAHHHHH,20
2082,886949749923958784,2017-07-17 14:04:33,12,0,12,False,AAAAAAAAAAAAAAAHHHHHHHHHHHHH,28
2083,886947233589014528,2017-07-17 13:54:33,13,3,16,False,AAHHH,5
2084,886944714687225856,2017-07-17 13:44:33,9,1,10,False,AAAAAAAAAAAAAAAAAAAAHHH,23
2085,886942200797560833,2017-07-17 13:34:33,5,2,7,False,"AHHHHH 
https://t.co/deNl6Na4DJ",31
2086,886939680943591425,2017-07-17 13:24:33,10,2,12,False,AAAAAAHHHHHHHHH,15
2087,886937167427244032,2017-07-17 13:14:33,9,3,12,False,AAAAAAHHHHHHHHHHHHHHHH,22
2088,886934653348851712,2017-07-17 13:04:34,9,4,13,False,AAAAAAAAAAAHHHH,15
2089,886932132593102848,2017-07-17 12:54:33,10,2,12,False,AAAAAAAAAAAAAAAAAAAAAAAHH,25
2090,886929616564363265,2017-07-17 12:44:33,18,6,24,False,AAAAAAAAAAAAAAAAAAAAAAHHHHHHHH,30
2091,886927100162322432,2017-07-17 12:34:33,12,8,20,False,AAAAAAAAAAAAAAAAAAHHHHHHH,25
2092,886924582590054405,2017-07-17 12:24:33,9,5,14,False,AAAAAAAAAAAAAAAAAAHHHHHHHHHHHHHHH,33
2093,886922064946450432,2017-07-17 12:14:33,13,3,16,False,AAAAAAAAAAAAAAAAAAAHHHHHHHHHHHH,31
2094,886920970770034690,2017-07-17 12:10:12,0,0,0,True,@DavidBilbert AAAAAAAAAHHHHHHHHHHHHH,36
2095,886919550071181312,2017-07-17 12:04:33,12,3,15,False,AAAAAAAAAAAAHHHHHHHHHHH,23
2096,886918454040723457,2017-07-17 12:00:12,1,0,1,True,@bluesilveryblue AAAAAAAAAAAAAAAAAAAAAHHH,41
2097,886917035111964672,2017-07-17 11:54:33,8,1,9,False,AAAAAAAAAAAAAAAAAAAAAAHH,24
2098,886914673353904128,2017-07-17 11:45:10,3,0,3,True,@bluesilveryblue AAAAAAAAAAAAAAAAAAAAAAAHHHHHHHHHHH,51
2099,886914516822392832,2017-07-17 11:44:33,7,0,7,False,AAAHHHHHHHHHHHHHHHH,19
2100,886911998491066368,2017-07-17 11:34:33,14,5,19,False,AAAAAAAAAAAAAHHHHHHHHHHHHHH,27
2101,886909483263430656,2017-07-17 11:24:33,9,0,9,False,AAAAAAAAAAAAAAAAAAAAAAH,23
2102,886906967884791808,2017-07-17 11:14:33,8,3,11,False,AAAAAHHH,8
2103,886904450018922499,2017-07-17 11:04:33,11,6,17,False,AAAAAAAAAAAAAAAHHHHHHHHHHHHHHH,30
2104,886901935802126337,2017-07-17 10:54:33,5,0,5,False,AAAHHH,6
2105,886899418070491136,2017-07-17 10:44:33,6,1,7,False,AAAHHHH,7
2106,886896899235729409,2017-07-17 10:34:33,8,3,11,False,AAAAHHHHHHHHHHHHHHHH,20
2107,886894382544236544,2017-07-17 10:24:33,10,1,11,False,AAAAAAAAAAAAAAAHHHHHHHHHH,25
2108,886891865768964097,2017-07-17 10:14:33,7,2,9,False,AAAAAAAAAAAAAAAAAAH,19
2109,886889506942668801,2017-07-17 10:05:10,0,0,0,True,@micki_stone AAAAAAAHHHHHHHHHHHHH,33
2110,886889349413052416,2017-07-17 10:04:33,6,0,6,False,AAAAAAAAAHHH,12
2111,886886833443008512,2017-07-17 09:54:33,9,2,11,False,AAAAHHHHHHHHHHHHHHH,19
2112,886884478269915140,2017-07-17 09:45:11,0,0,0,True,@Sb_spark AAAHHHHHHHH,21
2113,886884316520886272,2017-07-17 09:44:33,7,2,9,False,AAAAAAAAAAAAAAAAAAAAAAAHHH,26
2114,886883221119660032,2017-07-17 09:40:12,1,0,1,True,@Sb_spark AAAAAAAAAAAAAAAAAAAHHHHHHHHHHHHHHHH,45
2115,886881961888935936,2017-07-17 09:35:11,1,0,1,True,@Sb_spark AAAAAAAAAAAAAAAAAAAAAAHH,34
2116,886881799800061952,2017-07-17 09:34:33,6,1,7,False,AAAAAAAAAAAAAAAAAAAAAHHH,24
2117,886879286266920960,2017-07-17 09:24:33,13,6,19,False,AAAAAAAAAAAAAAAAAAAAHHHHHHHHH,29
2118,886876768015187970,2017-07-17 09:14:33,10,4,14,False,AAAAAAAAAAAAAAAAAAAAAAHHHHHH,28
2119,886874252393283586,2017-07-17 09:04:33,4,0,4,False,AAAAAH,6
2120,886871733273337856,2017-07-17 08:54:33,6,0,6,False,AAAAAHH,7
2121,886869216720285696,2017-07-17 08:44:33,5,0,5,False,AAAAAAAAAAAAAAAAAAAHHHH,23
2122,886866699663921153,2017-07-17 08:34:33,7,3,10,False,AHHH,4
2123,886864184062988288,2017-07-17 08:24:33,5,0,5,False,AAAAAAAAAHHHHHH,15
2124,886861670471135232,2017-07-17 08:14:33,14,5,19,False,AAAAAAAAAAAAAAAAAAHHHHHHHHHHHHH,31
2125,886859153855188992,2017-07-17 08:04:33,5,0,5,False,AAAAAAAAAAAAAAAAH,17
2126,886856635725041664,2017-07-17 07:54:33,6,1,7,False,AAAAAAAAAHHHHH,14
2127,886854121915133952,2017-07-17 07:44:34,5,4,9,False,AAAAHHHHHHHHHHHHHH,18
2128,886851602765709312,2017-07-17 07:34:33,9,4,13,False,AAAAAAAAAAAAAAAAHHHHHHHHHHH,27
2129,886849085818449920,2017-07-17 07:24:33,2,0,2,False,AHHHHHHHHHHH,12
2130,886846569324085248,2017-07-17 07:14:33,3,0,3,False,AHHHHHHHH,9
2131,886844054645993472,2017-07-17 07:04:34,5,0,5,False,AHHHHHHHHHH,11
2132,886841532988502016,2017-07-17 06:54:32,10,2,12,False,AAAAAAAAAAAAAAAAAAHHHHHHHHH,27
2133,886840435297198080,2017-07-17 06:50:11,0,0,0,True,@Arguably_Random AAAAAAAAAAAAAAAAAAHHHHHHHHHH,45
2134,886839176230039554,2017-07-17 06:45:10,1,0,1,True,@keepyalifeyours AAAAAAAAAAAH,29
2135,886839020482854913,2017-07-17 06:44:33,8,3,11,False,AAAAAAAAAAAAAAAAAHHHHHHHHHHH,28
2136,886837921222983680,2017-07-17 06:40:11,0,0,0,True,@thewizardgibbon AAAAAAAAAAAAAAAAAAAAAAAHHHH,44
2137,886837921218736131,2017-07-17 06:40:11,1,0,1,True,@keepyalifeyours AAAAHHHHHHHHHHHHHHH,36
2138,886836500721172481,2017-07-17 06:34:33,7,2,9,False,AAAAAAAAAAAAAAAAAHHHH,21
2139,886835402610401280,2017-07-17 06:30:11,1,1,2,True,@keepyalifeyours AAAAAAAAAAAAAAAAAAAAAAHH,41
2140,886833985426477056,2017-07-17 06:24:33,19,5,24,False,AAAAAAAAAAAAAAAAAAAHHHHHHHHHHHHHH,33
2141,886831469485850624,2017-07-17 06:14:33,9,1,10,False,AAAAAAAHHHHHHHH,15
2142,886828953847164928,2017-07-17 06:04:33,7,0,7,False,AAAAAAAAAAAAAAHHHHHHHHHHHHHHH,29
2143,886826438061674497,2017-07-17 05:54:33,10,2,12,False,AAAHH,5
2144,886823917192716288,2017-07-17 05:44:32,8,1,9,False,AAHHHH,6
2145,886821402757795840,2017-07-17 05:34:33,13,6,19,False,AAAAAAAAAAHHHHHHHHHHH,21
2146,886818885722406912,2017-07-17 05:24:33,12,4,16,False,AAAAAAAAAAAAAAHH,16
2147,886816370519937024,2017-07-17 05:14:33,10,4,14,False,AAAAAAHHHHHHHHHHHHH,19
2148,886813854478602240,2017-07-17 05:04:33,6,2,8,False,AAAAAAHH,8
2149,886811334360403969,2017-07-17 04:54:32,7,0,7,False,AAAAAAAAAAAHHHHHHH,18
2150,886808819128467456,2017-07-17 04:44:33,10,3,13,False,AAAAHHHHHH,10
2151,886806302537781248,2017-07-17 04:34:33,9,1,10,False,AHHHHHHHHHHHHHH,15
2152,886803944667832320,2017-07-17 04:25:11,0,0,0,True,@h1gg5b0s0n AAAAAAAAAH,22
2153,886803786378993664,2017-07-17 04:24:33,7,3,10,False,AAAAAAAHHHHHHHHHHHH,19
2154,886802687685165056,2017-07-17 04:20:11,0,1,1,True,@h1gg5b0s0n AAAAAAAAAAAAAAHHHHHHHHHHHHHHHH,42
2155,886801268559273984,2017-07-17 04:14:33,8,1,9,False,AAAAHH,6
2156,886798755781062658,2017-07-17 04:04:33,4,0,4,False,AHHHHHHHHHHHH,13
2157,886796234295574528,2017-07-17 03:54:32,6,2,8,False,AAAAAAAAAAAAAAAAHHHHH,21
2158,886793717998391296,2017-07-17 03:44:32,8,3,11,False,AAAAAAAAAAAAHHHHHHHH,20
2159,886791204406427652,2017-07-17 03:34:33,11,4,15,False,AAAAAAAHHHHHHHHHH,17
2160,886788689136934913,2017-07-17 03:24:33,8,2,10,False,AAAAAAAAAAAAAAAAHH,18
2161,886786170423783425,2017-07-17 03:14:33,15,4,19,False,AAAAAAAAAAAAAAAHHHHHHHH,23
2162,886783653770133504,2017-07-17 03:04:33,14,4,18,False,AAAAAAAAAAAAAAAAAAHHHH,22
2163,886782556829605889,2017-07-17 03:00:11,1,0,1,True,@b_a_tank AAHH,14
2164,886781138458599424,2017-07-17 02:54:33,12,3,15,False,AAAAHHHHHHHHHH,14
2165,886778618692718593,2017-07-17 02:44:32,8,1,9,False,AAAAHHHHHHHHHHHHH,17
2166,886776105323114496,2017-07-17 02:34:33,8,2,10,False,AAAAAAAAH,9
2167,886773588560412673,2017-07-17 02:24:33,12,5,17,False,AAAAAAAAAAAAAAAAHHHHHHHHH,25
2168,886771071415922688,2017-07-17 02:14:33,11,2,13,False,AAAAAAHHHHH,11
2169,886768556846854144,2017-07-17 02:04:33,7,0,7,False,AAAAAAAAAAAAAAHHHHH,19
2170,886766038272159745,2017-07-17 01:54:33,12,3,15,False,AAAAAAAHHHHHHHHHHH,18
2171,886763521740070913,2017-07-17 01:44:33,14,13,27,False,AAAAAAAAAAAAAAHHHHHHHHHHHHHHHH,30
2172,886761006055272448,2017-07-17 01:34:33,18,6,24,False,AAAAAAAAAAAAAAAAAAAAAAAHH,25
2173,886758487665127427,2017-07-17 01:24:33,7,2,9,False,AAAAHHHH,8
2174,886755971539881985,2017-07-17 01:14:33,14,2,16,False,AAAAAAAAAAAAAAAAAAAAAAAHHHH,27
2175,886753460422676481,2017-07-17 01:04:34,8,1,9,False,"AAAAAAAAAAAAAAAAAHH 
https://t.co/GjpsuOA9j0",44
2176,886750938224087040,2017-07-17 00:54:33,10,4,14,False,AAAAAAAAAAAAAHHHH,17
2177,886749840071372801,2017-07-17 00:50:11,0,0,0,True,@aNarwhal AAAAAAAAAAAAAAAAAAH,29
2178,886748423717879809,2017-07-17 00:44:33,8,1,9,False,AAAAAAAAAAAAAAAAAAAAHHH,23
2179,886747324629876736,2017-07-17 00:40:11,0,0,0,True,@czarbucks AAAAAHHHHHH,22
2180,886745902769156106,2017-07-17 00:34:32,20,7,27,False,AAAAAAAAAAAAAAAAAHHHHHH,23
2181,886744802938716163,2017-07-17 00:30:10,0,0,0,True,@darknote62 AAAAAAHHHHH,23
2182,886743541988421632,2017-07-17 00:25:09,0,0,0,True,@darknote62 AAAAAAAAAAHHH,25
2183,886743387155705856,2017-07-17 00:24:33,4,3,7,False,AAAAAAAAAAAAAAAHHHHHHH,22
2184,886740870623571969,2017-07-17 00:14:33,10,1,11,False,AAAAAAAAAAAAAHHHHHHHHHH,23
2185,886738356134170624,2017-07-17 00:04:33,12,1,13,False,AAAAAAAAAAH,11
2186,886735837454585857,2017-07-16 23:54:33,13,2,15,False,AAAAAAAAAAAAAAAAAAHHH,21
2187,886733323720118273,2017-07-16 23:44:33,13,5,18,False,AAAAAAAAAAAAAAAAAAAAHHHHHH,26
2188,886730804197511168,2017-07-16 23:34:33,11,3,14,False,AAAAAAAAAAAAAAHHHHHHH,21
2189,886729707907162112,2017-07-16 23:30:11,0,0,0,True,@scienceovermyth AAAAAAAAAAAAHHHH,33
2190,886728289284485120,2017-07-16 23:24:33,15,5,20,False,AAAAAAAAAAAHH,13
2191,886725772299448320,2017-07-16 23:14:33,11,5,16,False,AAAAAAAAAHHHHHHHHHHHH,21
2192,886723256853647364,2017-07-16 23:04:33,10,4,14,False,AAAAAAAAAAAAAAAAAHH,19
2193,886720738090246145,2017-07-16 22:54:33,13,8,21,False,AAAAAAAAHHHHH,13
2194,886719638507225090,2017-07-16 22:50:10,0,0,0,True,@naaazanin AAAAAAAAAAAAAAAAAAAAAAAHHHHHHHHHH,44
2195,886718376889995264,2017-07-16 22:45:10,0,0,0,True,@naaazanin AAAAAHHHHHHHHHHH,27
2196,886718376864821248,2017-07-16 22:45:10,1,0,1,True,@mr_moltafetam AHHHHHHHHHHHH,28
2197,886718222019514368,2017-07-16 22:44:33,9,4,13,False,AAHHHHHHHHHHH,13
2198,886717122025594881,2017-07-16 22:40:10,0,0,0,True,@naaazanin AAHHHHHHHHHHH,24
2199,886717121975201792,2017-07-16 22:40:10,0,0,0,True,@S_o_l_i_ AAAAAAAAAH,20
2200,886717121958477827,2017-07-16 22:40:10,0,0,0,True,@mr_moltafetam AAAAAAAAAAAAAH,29
2201,886715859657535490,2017-07-16 22:35:09,1,0,1,True,@S_o_l_i_ AHHHHH,16
2202,886715859632304134,2017-07-16 22:35:09,0,0,0,True,@naaazanin AAAAAAAAAAAAAAAAAAAAH,32
2203,886715859628109824,2017-07-16 22:35:09,0,0,0,True,@mr_moltafetam AAAAAAAAAAAAAAAAAAHHHH,37
2204,886715859623972866,2017-07-16 22:35:09,0,0,0,True,@mr_moltafetam AAAAAAAAAAAHHHH,30
2205,886715707987283969,2017-07-16 22:34:33,21,7,28,False,AAAAAAAAAAAAAAAAAAAHHHHHHHHHHHHH,32
2206,886714609259999235,2017-07-16 22:30:11,0,0,0,True,@mr_moltafetam AAAAAAAAAAAAAAAAAAAAAHHHHHHHHHHHHH,49
2207,886714609251614720,2017-07-16 22:30:11,0,0,0,True,@mr_moltafetam AAAAAAAAAAAAAAAAAAAAAAAH,39
2208,886714609205489665,2017-07-16 22:30:11,0,0,0,True,@S_o_l_i_ AAAAAAAAAAAAAAAAAAAAAAAHHHHH,38
2209,886714609201278976,2017-07-16 22:30:11,0,0,0,True,@mr_moltafetam AAAAAAAAAAAAAAAAAHHH,35
2210,886714609192849410,2017-07-16 22:30:11,0,0,0,True,@S_o_l_i_ AAAAAAAHHHHHHHHHHHHH,30
2211,886714609184460802,2017-07-16 22:30:11,0,0,0,True,@naaazanin AAAAAAAAAAAAAAAAAAAAAHHHHHHHHHHHH,44
2212,886714609184460800,2017-07-16 22:30:11,0,0,0,True,@S_o_l_i_ AAAAAAAAAAAAAAAAAHHHHHHHHHHHHH,40
2213,886713345214214148,2017-07-16 22:25:10,0,0,0,True,@S_o_l_i_ AAAAAAAAAAAAAAAAAAHHHH,32
2214,886713345193259009,2017-07-16 22:25:10,0,0,0,True,@mr_moltafetam AAAAAAAAAAAAAAAAAAAAAAAHHHHHHHHHH,48
2215,886713345189048320,2017-07-16 22:25:10,0,0,0,True,@S_o_l_i_ AAAAAAHHHHHHHHHHHHHHHH,32
2216,886713191161638913,2017-07-16 22:24:33,9,6,15,False,AAAAAAAAAAAAAAAAAAAAH,21
2217,886712092451057665,2017-07-16 22:20:11,0,0,0,True,@S_o_l_i_ AAAAAAAAAAAAAAHHHHH,29
2218,886712092434235392,2017-07-16 22:20:11,0,0,0,True,@mr_moltafetam AAAAAAAAAAAAAHHHHHHHHHHHHHHHH,44
2219,886710673182511105,2017-07-16 22:14:33,10,0,10,False,AAAAAHHHHHHH,12
2220,886708317858430977,2017-07-16 22:05:11,0,0,0,True,@mattrooney11 AAAAAAAHHHHHHHH,29
2221,886708155123732481,2017-07-16 22:04:33,10,3,13,False,AAAAAAAAAAAAAAAAAAAAAAAHHHHHHHHHHHH,35
2222,886705642043580416,2017-07-16 21:54:33,10,4,14,False,AAAHHHHHHHHHHH,14
2223,886703122458058752,2017-07-16 21:44:33,15,6,21,False,AAAAAAAAAAAAHHHHHHHHHHHHHHH,27
2224,886700604495712256,2017-07-16 21:34:32,9,3,12,False,AAHH,4
2225,886698091004514304,2017-07-16 21:24:33,9,3,12,False,AAAAAAAAAHH,11
2226,886695728646631425,2017-07-16 21:15:10,0,0,0,True,@Missinggospel AAHH,19
2227,886695572412956672,2017-07-16 21:14:33,13,1,14,False,AAAAAAAAAAAAAAHHH,17
2228,886694475333906434,2017-07-16 21:10:11,0,0,0,True,@ironlady920401 AAAAAAAAAAAAAAAAAHHHHHHHHHHHHH,46
2229,886694475233460224,2017-07-16 21:10:11,0,0,0,True,"@mr_moltafetam AAAAAAAAAAAAAAAAAAAAHHHHHHHHHHHHH 
https://t.co/GjpsuOA9j0",73
2230,886693212064276481,2017-07-16 21:05:10,0,0,0,True,@mr_moltafetam AAAAAAAAAAAAAAAAHHHHHHHHHHHHHHHH,47
2231,886693211858763776,2017-07-16 21:05:10,0,0,0,True,@defectiveMom AAAAAAAAAAAAAHHHHHHHH,35
2232,886693058330361856,2017-07-16 21:04:33,14,4,18,False,"AAAAAAAAAAAHHH 
https://t.co/yV4Viu5hXX",39
2233,886691963084341248,2017-07-16 21:00:12,0,0,0,True,@Mpeyman01 AAAAAAAAAAAAAAAAAAAAAAAHH,36
2234,886691963004755968,2017-07-16 21:00:12,0,0,0,True,@SuperJulia AAAAAAAAAAAAAAAAAAAAAH,34
2235,886691963004702720,2017-07-16 21:00:12,0,0,0,True,@Missinggospel AAAAAAAAAAAAAAAAHHHHHHHHHHHHHHHH,47
2236,886690541672562688,2017-07-16 20:54:33,18,3,21,False,AAAAAAAAAAAAAAHHHHHHHH,22
2237,886689441376612353,2017-07-16 20:50:11,0,0,0,True,@Missinggospel AAAAAAAAAAAHHHH,30
2238,886689441364029441,2017-07-16 20:50:11,0,0,0,True,@Mpeyman01 AAAAAAAAH,20
2239,886688025035649027,2017-07-16 20:44:33,9,3,12,False,AAAAAAAAHHHHHHHHHHHHHHHH,24
2240,886685506821599232,2017-07-16 20:34:33,12,0,12,False,AAAAAAAAAAAAAAAAAAAAAAAHHHHHHHHH,32
2241,886683145143300096,2017-07-16 20:25:10,0,0,0,True,@mojgan_fr AAAAAAAAAAAAHHHHHHHHHHHHHH,37
2242,886683145143291904,2017-07-16 20:25:10,0,0,0,True,@mr_moltafetam AAAHHHHHHH,25
2243,886683145126506497,2017-07-16 20:25:10,0,0,0,True,@mojgan_fr AAAAAAAAAAAAHHHHHHHHHHHHHH,37
2244,886683145105494017,2017-07-16 20:25:10,0,0,0,True,@mojgan_fr AAAAAAAAAAAAAAAAAAAHHHHHHHHHHHHHHH,45
2245,886683145071886337,2017-07-16 20:25:10,0,0,0,True,@Mpeyman01 AAHHHHHHH,20
2246,886683145055207424,2017-07-16 20:25:10,0,0,0,True,@Mpeyman01 AAAAAAAAAAAAAAAAAAAAAAHHHHHHHHHHHH,45
2247,886683145038426112,2017-07-16 20:25:10,0,0,0,True,@mojgan_fr AAAAAAAAAAAAAAAAHHHHH,32
2248,886683145038385152,2017-07-16 20:25:10,0,0,0,True,"@mr_moltafetam AAAAAAAAAAAAAAAHHHHHHHHH 
https://t.co/RCixkFG5QR",64
2249,886683145030029312,2017-07-16 20:25:10,0,0,0,True,@Mpeyman01 AAAAAAAAAAAAAHHHH,28
2250,886682988435709953,2017-07-16 20:24:32,9,2,11,False,AAAAAAAAAAAAHHHHHH,18
2251,886681889062498304,2017-07-16 20:20:10,0,0,0,True,@mojgan_fr AAAAAAAAAHHHHHHHHH,29
2252,886681888991186944,2017-07-16 20:20:10,0,0,0,True,@mojgan_fr AAAAAHHHHHHHHHHHHHHH,31
2253,886681888982781952,2017-07-16 20:20:10,0,0,0,True,@lastseen00 AAAAAAAAAAAAAHHHHHHHHH,34
2254,886681888945045504,2017-07-16 20:20:10,0,0,0,True,@mojgan_fr AAAAAAAAAAAAAAAHHHHHHHH,34
2255,886681888919887872,2017-07-16 20:20:10,0,0,0,True,@mr_moltafetam AAAAAAAAAAHHHHHHH,32
2256,886680474780913664,2017-07-16 20:14:33,4,3,7,False,AAAAAAAAAAAAAAAAAAH,19
2257,886677957569327105,2017-07-16 20:04:33,11,8,19,False,AAAAAAAAAAAAHHHHHHHHHHHH,24
2258,886675439514783744,2017-07-16 19:54:33,10,4,14,False,AAAAAAAAAAAAAAAAAAAHHHHHHHHHHHHHHHH,35
2259,886672924572307457,2017-07-16 19:44:33,5,0,5,False,AAAHHHHHHHHHHHHHH,17
2260,886671826360958982,2017-07-16 19:40:11,0,0,0,True,@darknote62 AAAAAAAAHHHHHHHHHHHHHH,34
2261,886670406844854274,2017-07-16 19:34:33,6,3,9,False,AAAAAAAAAAAAAAAAHHHH,20
2262,886668048194785280,2017-07-16 19:25:10,0,0,0,True,@PierceKeith AAAAAAAAAAAAAAAAAHHHHHHHHHH,40
2263,886668048190627840,2017-07-16 19:25:10,2,0,2,True,@kyleniemeyer AAAAAAAAAAAHHHHHHHH,33
2264,886667893336920069,2017-07-16 19:24:33,7,2,9,False,AAAAAHHHHHHHHHHHHHHHH,21
2265,886665374393131012,2017-07-16 19:14:33,7,3,10,False,AAAAAAAAAAAAAAAAAAAAAAHHHHHHH,29
2266,886662860214079489,2017-07-16 19:04:33,7,2,9,False,AAAAAAAAAAHHHHHH,16
2267,886660524523507712,2017-07-16 18:55:17,0,0,0,True,@danny1878c AAAAAAAAAAHHHHHHHHHHH,33
2268,886660342692147210,2017-07-16 18:54:33,7,2,9,False,AAAHHHHH,8
2269,886659242819801090,2017-07-16 18:50:11,1,1,2,True,@danny1878c AAAAAAAAAAHHHH,26
2270,886659242811432961,2017-07-16 18:50:11,0,0,0,True,@AstroDwarf AAAAAAAAAAAHH,25
2271,886657826571071488,2017-07-16 18:44:33,17,7,24,False,AAAAAAAAAAAAAAAAAAAAHHHHHHHHHH,30
2272,886655309804183553,2017-07-16 18:34:33,7,0,7,False,AHHHHHHHHHHHHHHH,16
2273,886652793536249856,2017-07-16 18:24:33,6,3,9,False,AAAAAHHHHH,10
2274,886650276287062017,2017-07-16 18:14:33,9,0,9,False,AAAAHHHHHHHH,12
2275,886647759574585344,2017-07-16 18:04:33,12,2,14,False,AAHHHHHHHHHHHHH,15
2276,886645242706964480,2017-07-16 17:54:33,10,1,11,False,AAAAAAHHHHHHHHH,15
2277,886642725801603076,2017-07-16 17:44:33,13,8,21,False,AAAAAAAAAAAAAAAAAAAAAAHHHHHHHH,30
2278,886640208019693569,2017-07-16 17:34:33,8,3,11,False,AAAHHHH,7
2279,886637690573266944,2017-07-16 17:24:33,13,2,15,False,AAAHHHHHHHHHHHHH,16
2280,886635175031050241,2017-07-16 17:14:33,9,5,14,False,AAAAAAAAAAAAAAHHHHHHHHHHHH,26
2281,886632659937636352,2017-07-16 17:04:33,19,5,24,False,AAAAAAAAAAAAAAHHHHHHHHHH,24
2282,886630143095173121,2017-07-16 16:54:33,10,6,16,False,AAAAAAAAAAAAAAAAAAAAAAHHHHHH,28
2283,886629043176706048,2017-07-16 16:50:11,0,0,0,True,@babyshoesmcgee AAAAAAAHHH,26
2284,886627625023803392,2017-07-16 16:44:33,11,5,16,False,AAAAAAAAAAAAAAAAAAAAAAHHHHH,27
2285,886625110249144320,2017-07-16 16:34:33,7,3,10,False,AAAAAAHHHHHHHHHH,16
2286,886622592412659713,2017-07-16 16:24:33,7,2,9,False,AHHHH,5
2287,886620075536646144,2017-07-16 16:14:33,13,1,14,False,AAAAAAAAAAHH,12
2288,886618977212002304,2017-07-16 16:10:11,0,0,0,True,@nani_booboo AAAAAAAAAAAAAAAAAAAAAAAHHHH,40
2289,886617560418045958,2017-07-16 16:04:33,11,4,15,False,AAAAAAAAAAAAAAAAAAAAAAAH,24
2290,886615042833219584,2017-07-16 15:54:33,10,1,11,False,AAAAAAAAAAAHHHHHHHHHHHHH,24
2291,886612528515735553,2017-07-16 15:44:33,5,2,7,False,AAAAAAAHH,9
2292,886610010364678145,2017-07-16 15:34:33,12,7,19,False,AAAAAAAHHHHHHHHHHHHH,20
2293,886607491076849664,2017-07-16 15:24:32,9,2,11,False,AAAAAAAAAAHHHHHHHHHHHHHHH,25
2294,886605131613122561,2017-07-16 15:15:10,0,0,0,True,@Mpeyman01 AAAAAAAAAAAAAAAAAAAAHHHHH,36
2295,886604976507809793,2017-07-16 15:14:33,20,16,36,False,AAAAAAAAAAAAAAAAAHHHHHHHHHHHH,29
2296,886603877398827008,2017-07-16 15:10:11,0,0,0,True,@ironlady920401 AAHHHHHHH,25
2297,886603877382070272,2017-07-16 15:10:11,0,0,0,True,@ironlady920401 AAAAAAAAAAAAAAAAAAAAAAHHHHHHHHHHHHHHHH,54
2298,886602616909778944,2017-07-16 15:05:10,0,0,0,True,@sekamhabs AAAAAAAAAAAAHHHHH,28
2299,886602457895366657,2017-07-16 15:04:32,12,6,18,False,AAAAAAAAAAAAAAAHHHHHH,21
2300,886599942143344640,2017-07-16 14:54:33,9,6,15,False,AAAAAAHHHHHHH,13
2301,886597425678438402,2017-07-16 14:44:33,5,2,7,False,AAAAAAAAAHHHHHHHHHHHHHH,23
2302,886596326967914499,2017-07-16 14:40:11,0,0,0,True,@TinaMWJ AAAAAAAAAAAAAAAAAAHHHHHHH,34
2303,886594909842681856,2017-07-16 14:34:33,6,7,13,False,AAAAAAAAAAAAAAAAAAAAAAAHHHHHHHHHH,33
2304,886592394732462081,2017-07-16 14:24:33,6,0,6,False,AAAAAHHHH,9
2305,886589878003281925,2017-07-16 14:14:33,7,4,11,False,AAAAAAAAAAAHHHHH,16
2306,886587361089531906,2017-07-16 14:04:33,5,1,6,False,AAAAAAHHHHHHHHHHHHH,19
2307,886584999776063488,2017-07-16 13:55:10,0,0,0,True,@Gattinov AAAAAAAAAAAAAAAAAAAHHHHHHHHHHHHH,42
2308,886584841868890113,2017-07-16 13:54:32,10,2,12,False,AAAAAAAAAAAAAAAAAAAAHHHHHHHH,28
2309,886582327136145408,2017-07-16 13:44:33,8,1,9,False,AHHHHHHHHHHHH,13
2310,886579809182199808,2017-07-16 13:34:33,10,3,13,False,AAAAAAAAAAHHHHHHHHHHHHH,23
2311,886577294487298052,2017-07-16 13:24:33,7,0,7,False,AAAAAAAAAAAAAAAAHHHHHHHHHHH,27
2312,886574775296024578,2017-07-16 13:14:32,8,0,8,False,AAAAHHHHHH,10
2313,886572265906855937,2017-07-16 13:04:34,13,4,17,False,AAAAAAAAAAAAAAAAAAAHHHHHHHHHH,29
2314,886569745360846848,2017-07-16 12:54:33,10,1,11,False,AAAAAAAAAAHHH,13
2315,886567226089910272,2017-07-16 12:44:32,8,2,10,False,AAAAHHHHHHHHHHHHHH,18
2316,886564868840710144,2017-07-16 12:35:10,0,0,0,True,@defectiveMom AAAAAAHHHHHHHHHHH,31
2317,886564712137334785,2017-07-16 12:34:33,10,4,14,False,AAAAAAAAAAAAAAAAAAAAHHHHHHHHHHH,31
2318,886562194766344192,2017-07-16 12:24:33,7,2,9,False,AAAAAAAAAAAHHHHHHHH,19
2319,886559679668772864,2017-07-16 12:14:33,17,0,17,False,AAAAAAAAAAAAAHHHHHHHHH,22
2320,886557162209779712,2017-07-16 12:04:33,14,4,18,False,AAAAAAAAAAAAAAAAAAAAHHHHHHHHHHHHHH,34
2321,886554643509248001,2017-07-16 11:54:33,12,3,15,False,AAAAAAAAAAAAAAAAAAHHHHHHHHH,27
2322,886552129342668800,2017-07-16 11:44:33,12,1,13,False,AAAAAAAAAAAAAAAAAAAHHHHHHHHH,28
2323,886549611925708800,2017-07-16 11:34:33,7,0,7,False,AAAAAAAAHHHHHHHHHHHHHH,22
2324,886547097046192128,2017-07-16 11:24:33,6,2,8,False,AAHHHH,6
2325,886545998511841282,2017-07-16 11:20:11,0,0,0,True,@sekamhabs AAAAAAAAAAAAAAAHHHHH,31
2326,886544578031087616,2017-07-16 11:14:33,7,0,7,False,AAAAAAAAAAAAAAAHHHH,19
2327,886542220991631360,2017-07-16 11:05:11,0,0,0,True,@mr_moltafetam AAAAAAAAAAAAHHHHHH,33
2328,886542220962213888,2017-07-16 11:05:11,0,0,0,True,@_rezrez_ AAAAAHHHHHHHHHHHHH,28
2329,886542061356412928,2017-07-16 11:04:33,9,1,10,False,AAAAAAAAAHHHHHH,15
2330,886540979284701184,2017-07-16 11:00:15,0,0,0,True,@mr_moltafetam AAAAAAAHHHHHHHHHH,32
2331,886539699820658688,2017-07-16 10:55:10,0,0,0,True,@_rezrez_ AAAAHHHHH,19
2332,886539544203591683,2017-07-16 10:54:33,7,4,11,False,AAAAAAAAAAAAAAAAAAAAAAHHHHHHHHHHHHHH,36
2333,886538444603891717,2017-07-16 10:50:10,0,0,0,True,@Draconis1999 AAAAAAAAHHHHHHHHHHHHHH,36
2334,886537026845147136,2017-07-16 10:44:32,6,0,6,False,AAAAAAAAHHHHHHHHHHH,19
2335,886534513412763649,2017-07-16 10:34:33,7,1,8,False,AAAAAAAAAAAAHHHHHHHHHHH,23
2336,886531995077095424,2017-07-16 10:24:33,4,0,4,False,AAAAAAAAAH,10
2337,886530898061123585,2017-07-16 10:20:11,0,0,0,True,@_rezrez_ AAAAAAAAAAAAAAH,25
2338,886529478784151552,2017-07-16 10:14:33,6,1,7,False,AAAAAAAAAAAAAAAAAAAAAAAHHH,26
2339,886526963422199810,2017-07-16 10:04:33,7,4,11,False,AAAAAAAAAAAAAAAAAAHHHHHHHHHH,28
2340,886524603320938496,2017-07-16 09:55:10,0,0,0,True,@ishishakish AAAAAAAAAAAAAAAAAAAAAAHHHHHHHH,43
2341,886524603312594944,2017-07-16 09:55:10,0,0,0,True,@nyctophilia_shl AAAAAAAAAAAAAAAAAAHH,37
2342,886524603300032512,2017-07-16 09:55:10,0,0,0,True,@_rezrez_ AAAAAAAAAAHHHH,24
2343,886524603300020224,2017-07-16 09:55:10,0,0,0,True,@mr_moltafetam AAAAAAAAHHHHHHHH,31
2344,886524603300007936,2017-07-16 09:55:10,0,0,0,True,@_rezrez_ AAAAHHHHH,19
2345,886524447405899776,2017-07-16 09:54:33,7,0,7,False,AAAAAAAAAAAAAHHHH,17
2346,886523350121631747,2017-07-16 09:50:12,0,0,0,True,@Miiss_fa AAAAAAAAAAAAAHHHHH,28
2347,886523349924540417,2017-07-16 09:50:12,0,0,0,True,@HazrateNaan AAAAAAAAHH,23
2348,886523349924540416,2017-07-16 09:50:12,0,0,0,True,@mr_moltafetam AAAAAAAAAAHHHHHHHHHHHHHHH,40
2349,886523349924536320,2017-07-16 09:50:12,0,0,0,True,@ishishakish AAAAAAAAAAHHHHHHHHHH,33
2350,886523349924499456,2017-07-16 09:50:12,1,0,1,True,@mr_moltafetam AAAAAHHH,23
2351,886523349920337920,2017-07-16 09:50:12,0,0,0,True,@Ghazaleschon AAAAAAAAAAHHHHHH,30
2352,886523349920296961,2017-07-16 09:50:12,0,0,0,True,@HazrateNaan AAAHHHHHHHHHH,26
2353,886523349916155904,2017-07-16 09:50:12,0,0,0,True,@_rezrez_ AHHHHHHHH,19
2354,886523349916147716,2017-07-16 09:50:12,0,0,0,True,@mr_moltafetam AAAAAAAAAAAAAHH,30
2355,886523349903474688,2017-07-16 09:50:12,2,1,3,True,@ishishakish AAAHHHH,20
2356,886523349886803968,2017-07-16 09:50:12,0,0,0,True,@nyctophilia_shl AAAAAAAAAAAAAAAAHH,35
2357,886522085085937664,2017-07-16 09:45:10,0,0,0,False,@naranji_rooobah AAAAAAAAAAAAAAAAAAAAHHHHHHHHHHHHH,50
2358,886522085010440192,2017-07-16 09:45:10,0,0,0,True,@sekamhabs AAAAAAAAAAAAAAAAAAAAAHHHHHHHH,40
2359,886522084997951488,2017-07-16 09:45:10,0,0,0,True,@nyctophilia_shl AAAAAAAAAAAAAAAAAAAAAAAHHHHH,45
2360,886522084972793858,2017-07-16 09:45:10,0,0,0,True,@mr_moltafetam AAAAAAAAAAAAAAAAAAAHHHHHHHHHHHHHHHH,50
2361,886522084964347908,2017-07-16 09:45:10,0,0,0,True,@novamber1982 AAAAAAAAHHHHHHHHHHHHHHHH,38
2362,886522084956024832,2017-07-16 09:45:10,0,0,0,True,@mojgan_fr AAAAAAHH,19
2363,886522084955914240,2017-07-16 09:45:10,0,0,0,True,@_rezrez_ AAAAAAAHHHHH,22
2364,886522084947628033,2017-07-16 09:45:10,0,0,0,True,@HazrateNaan AAAAAAAAAAAAAAAAHH,31
2365,886522084939137024,2017-07-16 09:45:10,0,0,0,True,@_aldaba_ AAHHHHHHHHHHHHHHH,27
2366,886522084935053312,2017-07-16 09:45:10,0,0,0,True,@nyctophilia_shl AHHHHHHHHH,27
2367,886522084934942722,2017-07-16 09:45:10,0,0,0,True,@_rezrez_ AAAHHHHHHHHHHH,24
2368,886522084930748416,2017-07-16 09:45:10,0,0,0,True,@mr_moltafetam AAAAAAAAAAAAAAAAAAAAHHHHHH,41
2369,886521928277782528,2017-07-16 09:44:33,7,3,10,False,AAAAAAAAAAAAAAAAAAAHHHH,23
2370,886520832922718208,2017-07-16 09:40:11,0,0,0,True,@_rezrez_ AAAHHHHHHHHHHHHHHH,28
2371,886520832834535424,2017-07-16 09:40:11,0,0,0,True,@_rezrez_ AAAAAAAAAAAAAAAAAAAAAAHHHHHHHHHHHHHHH,47
2372,886520832805220356,2017-07-16 09:40:11,0,0,0,True,@reasomania AAAAAAAAAAAAAAAH,28
2373,886520832792702976,2017-07-16 09:40:11,0,0,0,True,@Miiss_fa AAAAAAAAAAAAAAHHHHH,29
2374,886520832792694786,2017-07-16 09:40:11,0,0,0,True,@_rezrez_ AAAAAAAAAAHHHH,24
2375,886520832780107776,2017-07-16 09:40:11,0,0,0,True,@Miiss_fa AAHHHHHHH,19
2376,886520832775860224,2017-07-16 09:40:11,0,0,0,True,@_rezrez_ AAAAAAAAAAHHHHHHHHHHHHH,33
2377,886519573218025472,2017-07-16 09:35:11,0,0,0,True,@taha215ash AAAAAAAAAAAAAAAAHHHHHHHHHH,38
2378,886519573125754880,2017-07-16 09:35:11,0,0,0,True,@taha215ash AAAAAAAAHHHHHHHHHHHHH,33
2379,886519573108883456,2017-07-16 09:35:11,0,0,0,True,@reasomania AAAAAAAAAAAAAHH,27
2380,886519573096345600,2017-07-16 09:35:11,0,0,0,True,@novamber1982 AAAAAAAAHHHHHHHHHHHH,34
2381,886519573092216833,2017-07-16 09:35:11,0,0,0,True,@_rezrez_ AAAAAAAAAAAAAHH,25
2382,886519573079523328,2017-07-16 09:35:11,0,0,0,True,@_rezrez_ AAAAAAAAAAAAAAAAAAAAAAHHHHHHHHHHH,43
2383,886519573067034624,2017-07-16 09:35:11,0,0,0,True,@_rezrez_ AAAAAAAAAAAAAAAAAAAAAAAHHHHHHHHHHH,44
2384,886519573062840321,2017-07-16 09:35:11,0,0,0,True,@_rezrez_ AAAAAAAAAAAAAAAAAAAHHHHHHHHHHHH,41
2385,886519573046022144,2017-07-16 09:35:11,0,0,0,True,@novamber1982 AAAAAAHHHHHHHHHHHH,32
2386,886519573041860608,2017-07-16 09:35:11,0,0,0,True,@reasomania AAAH,16
2387,886519573037625344,2017-07-16 09:35:11,0,0,0,True,@_rezrez_ AAAAAAAAAAAAAAHHHHHHHH,32
2388,886519414111293440,2017-07-16 09:34:33,5,1,6,False,AAAAAAAAAAAAAHHHHHHH,20
2389,886518316201906176,2017-07-16 09:30:11,0,0,0,True,@Miiss_fa AAAAHHHHHHHHHHHHHHH,29
2390,886518316138979328,2017-07-16 09:30:11,0,0,0,True,@_rezrez_ AAAAAAAAAAAAAAAAHHHHH,31
2391,886518316126396416,2017-07-16 09:30:11,0,0,0,True,@_rezrez_ AAAAAAAAAAAAHHHHH,27
2392,886518316122222592,2017-07-16 09:30:11,0,0,0,True,@mojgan_fr AAAAAAAAHHHHH,24
2393,886518316113817600,2017-07-16 09:30:11,0,0,0,True,@Miiss_fa AAHHHHHHHHHHHHH,25
2394,886516897445031936,2017-07-16 09:24:33,13,4,17,False,AAAAAAAAAAAAAAAHHHHHHH,22
2395,886514378270547968,2017-07-16 09:14:33,1,0,1,False,AAAAAHHHHHHHHHHHHHH,19
2396,886511864787632128,2017-07-16 09:04:33,2,2,4,False,AAHHHHHHHHH,11
2397,886510769839452160,2017-07-16 09:00:12,0,0,0,True,@chuckyoutwo AAAAAAAAHHHHHHH,28
2398,886509345500008449,2017-07-16 08:54:33,5,0,5,False,AAAAAAAAAHHH,12
2399,886506830297485312,2017-07-16 08:44:33,12,2,14,False,AAAAHHHHHHHHHHHHHHH,19
2400,886504314646253568,2017-07-16 08:34:33,5,2,7,False,AAAAAAAAAAHHHH,14
2401,886501797875130368,2017-07-16 08:24:33,2,1,3,False,AAAAAAHHHHHHHHHHHH,18
2402,886499436775567360,2017-07-16 08:15:10,0,0,0,True,@firatserifgzgn AAAHHH,22
2403,886499281858949120,2017-07-16 08:14:33,5,2,7,False,AHHHHHH,7
2404,886496762919309313,2017-07-16 08:04:33,4,1,5,False,AAAAAH,6
2405,886495666662506496,2017-07-16 08:00:11,0,0,0,True,@firatserifgzgn AAAAAAAAAAAHHHHH,32
2406,886494246194352128,2017-07-16 07:54:33,9,0,9,False,AHHH,4
2407,886493147081191424,2017-07-16 07:50:11,0,0,0,True,@chuckyoutwo AAAAAAAAAAAAAAAAHHHHHHHHHHHHHHHH,45
2408,886491731000164352,2017-07-16 07:44:33,5,2,7,False,AAAAAAAAAAAH,12
2409,886489213109231617,2017-07-16 07:34:33,4,3,7,False,AAAAHHHHHHHHHHH,15
2410,886486695465684992,2017-07-16 07:24:32,11,5,16,False,AAAAAAAAHHHHHHHHHHHHH,21
2411,886484181735399424,2017-07-16 07:14:33,14,4,18,False,AAAAAAAAAAAAAAAAAAAAHHHH,24
2412,886481665060634626,2017-07-16 07:04:33,2,1,3,False,AAAAAAAAAAAAAAAAHHHHHHHH,24
2413,886479149325590528,2017-07-16 06:54:33,3,1,4,False,AAAHHHHHHHHHHHHHHHH,19
2414,886476632726401024,2017-07-16 06:44:33,9,4,13,False,AAAAAAAAAAAAAAAAAHHHHHHHHHHHHHH,31
2415,886474116156489733,2017-07-16 06:34:33,4,1,5,False,AAAAAAAAAAAAHHHHHHHH,20
2416,886471596222935040,2017-07-16 06:24:33,20,15,35,False,AAAAAAAAAAAAAAAAAAAHHHHHHHHHHH,30
2417,886469080043139072,2017-07-16 06:14:33,7,5,12,False,AAAHHHHHHHHHHH,14
2418,886466565172072448,2017-07-16 06:04:33,7,4,11,False,AAAAAAAAAAAAAAAHHHHHH,21
2419,886464048732278784,2017-07-16 05:54:33,6,1,7,False,AAAAAAH,7
2420,886461532976140288,2017-07-16 05:44:33,22,6,28,False,AAAAAAAAAAAAAAAAHHHH,20
2421,886459015869419520,2017-07-16 05:34:33,10,6,16,False,AAAAAAAAAAAAAAAAAAAAHHHHHHHHHHHHHHHH,36
2422,886456499077345281,2017-07-16 05:24:33,12,6,18,False,AHHHHHHHHHHH,12
2423,886453981551132672,2017-07-16 05:14:33,7,1,8,False,AAAHHHHH,8
2424,886451466327785473,2017-07-16 05:04:33,7,2,9,False,AAAAHHHHH,9
2425,886448947853758464,2017-07-16 04:54:33,5,5,10,False,AAAAAAAAAAAAAAAAAHH,19
2426,886446432236048385,2017-07-16 04:44:33,5,0,5,False,AAHHHHHHHHHHHH,14
2427,886445331713597441,2017-07-16 04:40:11,0,0,0,True,@MohammadaminM7 AAAAAAAAAAAAAAAAAAAAHH,38
2428,886444072457707520,2017-07-16 04:35:10,1,0,1,True,@MohammadaminM7 AAAAHHHHHHHHHH,30
2429,886443916584771584,2017-07-16 04:34:33,27,15,42,False,AAAAAAAAAAAAAAAAAAAAAHHHHHHHHHHHHH,34
2430,886441399700393986,2017-07-16 04:24:33,20,7,27,False,AAAAAAAAAAAAAAAAAAAAAHHHHHHHH,29
2431,886438882656620544,2017-07-16 04:14:33,11,3,14,False,AAAHHHHHHHHH,12
2432,886436364597817345,2017-07-16 04:04:33,13,2,15,False,AAAAAAAAAAAAAAAAAAAHHHHHH,25
2433,886433849328226305,2017-07-16 03:54:33,10,3,13,False,AAAAHHHHHHH,11
2434,886431332217356288,2017-07-16 03:44:33,17,0,17,False,AAAAAAAAAAAAAAAAAAAAAH,22
2435,886428816805167104,2017-07-16 03:34:33,10,2,12,False,AAAAAAAAAHHHHHHHHHHHHH,22
2436,886426300650586112,2017-07-16 03:24:33,7,1,8,False,AAAAAAAAAAAAAAAAAAHHH,21
2437,886423782373687300,2017-07-16 03:14:33,13,1,14,False,AAAAAAAHHHHHHH,14
2438,886421266617556992,2017-07-16 03:04:33,21,7,28,False,AAAAAAAAAAAAHHHHHHHHHHHHHH,26
2439,886420170670997504,2017-07-16 03:00:12,0,0,0,True,@sdg_mm AAAAAAAAAAAAAAAAAAAAAAHH,32
2440,886418749296963584,2017-07-16 02:54:33,14,1,15,False,AAAAAAAAAAAAAAAAAHHHHHHHHHH,27
2441,886416388369387521,2017-07-16 02:45:10,1,1,2,True,@nicocoer AAAAAAAAHHHHHHH,25
2442,886416235403116546,2017-07-16 02:44:33,7,3,10,False,AAAAAAAAAAAAAAAHHHHHHHHHHHHH,28
2443,886413717113643010,2017-07-16 02:34:33,3,6,9,False,AAAAAAAAAAAAHHHHHH,18
2444,886411198568202241,2017-07-16 02:24:33,14,7,21,False,AAAAAAAAAAAAAAAHHHHHHHHHHHHHHH,30
2445,886408683206451200,2017-07-16 02:14:33,4,6,10,False,AAHHHHHHHH,10
2446,886406165986521092,2017-07-16 02:04:33,22,11,33,False,AAAAAAAAAAAAAAAAAAAAAAHHHHHHHHHHHHHHH,37
2447,886403650809200641,2017-07-16 01:54:33,12,10,22,False,AAAAAAAAAAAAAHHHHHH,19
2448,886402552039972864,2017-07-16 01:50:11,0,0,0,True,@suannelqr AAHHHHHHHHHHHHHH,27
2449,886401133429784576,2017-07-16 01:44:33,12,3,15,False,AAAAAAAAAAAAAAAHHHHHHHHH,24
2450,886398615589195776,2017-07-16 01:34:33,6,2,8,False,AAAAAAAAAHHHH,13
2451,886396097844973569,2017-07-16 01:24:32,13,5,18,False,AAAAAAAAAAAAAAAAAAAAAHHH,24
2452,886393586144747522,2017-07-16 01:14:33,6,2,8,False,AAAAHHHHHHHHHHHH,16
2453,886391071143546887,2017-07-16 01:04:34,12,3,15,False,AAAAAAAAAAAAAAHHHHHHHHHHH,25
2454,886388549456670720,2017-07-16 00:54:33,15,8,23,False,AAAAAAAAAAAAAAAAAAAAAAAHHHHHH,29
2455,886386035285950464,2017-07-16 00:44:33,14,5,19,False,AAAAAAAAAAAAAAAAHHHHHHHHHHHHHHH,31
2456,886383516480655360,2017-07-16 00:34:33,11,1,12,False,AAAAAAAAAAAAAAAAAAAAAAHHHH,26
2457,886381000061845504,2017-07-16 00:24:33,12,2,14,False,AAAAHHH,7
2458,886379899186970624,2017-07-16 00:20:10,0,0,0,True,@beekme AAAAAAAHHH,18
2459,886378638609973252,2017-07-16 00:15:10,0,0,0,True,@keepyalifeyours AAAAAAAAAAHHHHHHHHHHHHHH,41
2460,886378486486761472,2017-07-16 00:14:33,12,0,12,False,AHHHHH,6
2461,886375967345790976,2017-07-16 00:04:33,14,0,14,False,AAAAAAAAAAAAAHHH,16
2462,886373449127657472,2017-07-15 23:54:32,25,11,36,False,AAAAAAAAAAAAAAAAAAAAHHHHHHHHHHHHHHH,35
2463,886371088707592192,2017-07-15 23:45:10,1,0,1,True,@keepyalifeyours AAAAAAAAAAAAAAAAAAHHHHHHH,42
2464,886370934243905537,2017-07-15 23:44:33,10,2,12,False,AAAAAAHHH,9
2465,886369835357286400,2017-07-15 23:40:11,1,1,2,True,@keepyalifeyours AHHHHHHHHHHHHH,31
2466,886368419586744320,2017-07-15 23:34:33,15,3,18,False,AAAAAAAAAAAAAAAAAAAHHHHHHHHHHHHHHH,34
2467,886365902656163841,2017-07-15 23:24:33,17,6,23,False,AAAAAAHHHHHHHHHHH,17
2468,886363383586586624,2017-07-15 23:14:33,15,7,22,False,AAAAAAAAAAAAAAAAHHHHHHHHH,25
2469,886360871458525184,2017-07-15 23:04:34,10,6,16,False,AAAAAAAAAAAAAHHHHHHHHHH,23
2470,886358351566819329,2017-07-15 22:54:33,12,6,18,False,AAAAAAAAAAAAAAHHHHHHHHHHHHHH,28
2471,886355833864564736,2017-07-15 22:44:33,7,3,10,False,AAAAAAAAAAHHH,13
2472,886353320092336130,2017-07-15 22:34:33,10,2,12,False,AAAAAAHHHHHHHH,14
2473,886352222170341376,2017-07-15 22:30:12,0,0,0,True,@mo_rf_i AAAAAAAAHHHHHHHHHHHHHH,31
2474,886350801643372544,2017-07-15 22:24:33,20,9,29,False,AAAAAAAAAHHHHHHHHHHHHHH,23
2475,886348285287510016,2017-07-15 22:14:33,10,7,17,False,AAAAAAAAAAAAAAAAAHHH,20
2476,886345923105828864,2017-07-15 22:05:10,1,0,1,True,@x3nome AAAAHHHH,16
2477,886345767232864256,2017-07-15 22:04:33,9,4,13,False,AAAAAAAAAAAAAAAAAAAHHHHHHH,26
2478,886343250545692674,2017-07-15 21:54:33,8,2,10,False,AAAAAAHH,8
2479,886340734181416961,2017-07-15 21:44:33,9,1,10,False,AAAAAAAAAAAAHH,14
2480,886338218119106560,2017-07-15 21:34:33,11,3,14,False,AAAAAAAAAAAAAAAHH,17
2481,886335858718244864,2017-07-15 21:25:10,0,0,0,True,@AssjackGames AAAAAAAAAAAAAAAAAAAAAAHHHHHHHH,44
2482,886335703872831493,2017-07-15 21:24:33,8,1,9,False,AHHHHHHHHHHHHH,14
2483,886333187693174788,2017-07-15 21:14:33,10,5,15,False,AAAAAAAAAAHHHHHHHHHHHH,22
2484,886330669890252800,2017-07-15 21:04:33,13,2,15,False,AAAAAAAAAAAAAAAAAAHHHHHH,24
2485,886328153387540481,2017-07-15 20:54:33,18,7,25,False,AAAAAAAAAAAAAAAAAAHHHHHHH,25
2486,886325792187318272,2017-07-15 20:45:10,0,0,0,True,@THEDAMASK AAAAAAAAAAAAAAAAAAAAAHHHH,36
2487,886325634108186624,2017-07-15 20:44:32,9,2,11,False,AAAAAAAHHHHHHHHHHHHHHHH,23
2488,886323120495374336,2017-07-15 20:34:33,22,8,30,False,AAAAAAAAAAAAAAAAAAAAAAHHHHHHHHHH,32
2489,886320604147789824,2017-07-15 20:24:33,12,4,16,False,AAAAAAAAAAAAAAAAAAAAAAAH,24
2490,886318087317934081,2017-07-15 20:14:33,14,4,18,False,AAAAAAHHHHHHHHHHHH,18
2491,886315570878132228,2017-07-15 20:04:33,13,2,15,False,AAAAAAAAAAAAAAAAAAAAAHHHHHHHHHHHHHHH,36
2492,886313055285641216,2017-07-15 19:54:33,11,4,15,False,AAAAAAAAAAAAAHHHHHHHHHHHHHHH,28
2493,886310535398133763,2017-07-15 19:44:33,16,2,18,False,AAAHHHHHHHHHHHH,15
2494,886308021554622464,2017-07-15 19:34:33,9,2,11,False,AAHHHHHHHHHH,12
2495,886305504619835392,2017-07-15 19:24:33,8,1,9,False,AAAAAAAAAAAAAHH,15
2496,886302987634782208,2017-07-15 19:14:33,10,1,11,False,AAAAAAAAAH,10
2497,886300473879351298,2017-07-15 19:04:34,7,4,11,False,AAAAAAAAHHHHHHHHHHHHHHHH,24
2498,886297951873769472,2017-07-15 18:54:33,19,4,23,False,AAAAAAAAAAAAAAAAAAAAAAHHHHHHHHHHHHH,35
2499,886295437963128832,2017-07-15 18:44:33,7,0,7,False,AAAAAAAAAHHHHHHHH,17
2500,886292919518408704,2017-07-15 18:34:33,6,1,7,False,AAAAAAAAAAAAAAAAAAAHH,21
2501,886290404311793664,2017-07-15 18:24:33,10,2,12,False,AAAAHHHHHHHHHH,14
2502,886287886756270081,2017-07-15 18:14:33,8,0,8,False,AAAAAAAAAAAHH,13
2503,886285371570610176,2017-07-15 18:04:33,5,1,6,False,AAAAAAAAHHHHHHHHH,17
2504,886282852752650240,2017-07-15 17:54:33,10,1,11,False,AAAAAAAAAAAAAAAAAAH,19
2505,886280335394254848,2017-07-15 17:44:32,14,2,16,False,AAAAAAAAAAAAAAAAAAHHHHHHHHHHHH,30
2506,886277821966028801,2017-07-15 17:34:33,8,3,11,False,AAAAAAAAHHHH,12
2507,886275303936577536,2017-07-15 17:24:33,8,2,10,False,AAAAAAAAAAAAAHHHHHHHHHHHH,25
2508,886272786519511040,2017-07-15 17:14:33,6,1,7,False,AAAAAAAAAAAAAHHHHHHH,20
2509,886270272332062722,2017-07-15 17:04:33,10,2,12,False,AAHHH,5
2510,886267754822684673,2017-07-15 16:54:33,8,1,9,False,AAAAHHHHHHHHHHHHHH,18
2511,886265239683162112,2017-07-15 16:44:33,15,4,19,False,AAAAAAAAAHHHHHHHHHHHH,21
2512,886262719455920129,2017-07-15 16:34:32,19,4,23,False,AAAAAAAAAAAAAAAAHHHHHHHHHHH,27
2513,886260206572900352,2017-07-15 16:24:33,13,4,17,False,AAAAAAAAAHHHHHHHHHHH,20
2514,886257688199520256,2017-07-15 16:14:33,8,1,9,False,AHHHHHHHHHHH,12
2515,886255325946552321,2017-07-15 16:05:10,0,0,0,True,@OuiRossignol AAAAAAHHHHHHHHHHHHHHH,35
2516,886255173345173505,2017-07-15 16:04:33,12,0,12,False,AAAAAAAAAAAAAAAAAAAAHHHHHHHHHH,30
2517,886252653289906176,2017-07-15 15:54:32,8,4,12,False,AAAAAAAAAAAAAAAAAHHHHHHH,24
2518,886251554180825088,2017-07-15 15:50:10,0,0,0,True,@LarkBrains AAAAAAAAAAAAAAAAAAAAAAAHHHHHHH,42
2519,886250140008427520,2017-07-15 15:44:33,10,1,11,False,AAAAAAAAAAAAAAAHHHHHHHH,23
2520,886247625716051969,2017-07-15 15:34:34,7,1,8,False,AHHHHHHH,8
2521,886245106319339520,2017-07-15 15:24:33,11,2,13,False,AAAAAAAAAAAAAAAAAAAHHHH,23
2522,886242742438957059,2017-07-15 15:15:10,1,0,1,True,@plumenvahseh AAHHHHHHHHHH,26
2523,886242586700152832,2017-07-15 15:14:32,14,4,18,False,AAAAAAAAAAAAAAAAAAAAHHHHHHHHHHH,31
2524,886241487918387200,2017-07-15 15:10:10,1,1,2,True,@plumenvahseh AAAHHHHHHHHHHHHHHHH,33
2525,886240074270208000,2017-07-15 15:04:33,14,7,21,False,AAAAAAAAAAAAAAAAAAAAAAAHHHHHHH,30
2526,886237556840448000,2017-07-15 14:54:33,6,1,7,False,AHHHHHHHHHH,11
2527,886235037380689920,2017-07-15 14:44:33,11,2,13,False,AAAAAAAAAAAAAAAAAHHHHHHHHHHHHHH,31
2528,886232523457662980,2017-07-15 14:34:33,11,4,15,False,AAAAAAAAAAAAAAAAAHHHHHHHHHHHHH,30
2529,886230004643897345,2017-07-15 14:24:33,12,3,15,False,AAAAAAAAAAAAAAAAAAAAHHHHHHHHHHHHH,33
2530,886227489772720130,2017-07-15 14:14:33,9,6,15,False,AAAAAAAAAAAAAHHHH,17
2531,886224972938719232,2017-07-15 14:04:33,14,2,16,False,AAAAAAAAAAAAAAAAAAAHHHHHHHH,27
2532,886223878711902209,2017-07-15 14:00:12,1,0,1,True,@defectiveMom AAAAAAAAAHHH,26
2533,886222457903906817,2017-07-15 13:54:33,4,1,5,False,AAAAAAAAHHHHHHHHHH,18
2534,886220095906881536,2017-07-15 13:45:10,0,0,0,True,@lkimial AAAAAAAAAAAAHHHHHHHHHHHHHHH,36
2535,886219940637888512,2017-07-15 13:44:33,10,2,12,False,AAAAAAAAHHHHHHHHHHHHH,21
2536,886217422738526212,2017-07-15 13:34:33,20,5,25,False,AAAAAAAAAAAAAAAAAHHHHHHHHHHHHHHH,32
2537,886214903962456064,2017-07-15 13:24:32,7,0,7,False,AAAAAAAAAAAAAAAAAHHHH,21
2538,886212391024906243,2017-07-15 13:14:33,10,1,11,False,AHHHHHHHHHHHHHHHH,17
2539,886209873444311040,2017-07-15 13:04:33,9,1,10,False,AAAAAAAAAAAAHHHHHHHHH,21
2540,886207355171426305,2017-07-15 12:54:33,11,5,16,False,AAAAAAAAAAAAAAAAAAAAAHHHHHHHHHH,31
2541,886206265151688704,2017-07-15 12:50:13,2,0,2,True,@StphnCalleja AAAAAAAAAAAAAAAAAAAAAAHHHHH,41
2542,886204838815682560,2017-07-15 12:44:33,13,4,17,False,AAAHHHHHHHHHH,13
2543,886202325861380096,2017-07-15 12:34:33,11,5,16,False,AAAAAAAAAAAAAAAAAAAHHHHHHHHHH,29
2544,886199808872075264,2017-07-15 12:24:33,4,2,6,False,AAAAAAAHHHHHHHHHHHHH,20
2545,886197290528112640,2017-07-15 12:14:33,6,2,8,False,AAAAAAAAAAAAAAAHH,17
2546,886194774977458176,2017-07-15 12:04:33,7,3,10,False,AAAAAAAAAAAAAHHHHH,18
2547,886192258621550592,2017-07-15 11:54:33,5,0,5,False,AAHHHHHHHHH,11
2548,886191159974014978,2017-07-15 11:50:11,0,1,1,True,@Black_Sheep_23 AAAAAAH,23
2549,886189741506514946,2017-07-15 11:44:33,5,1,6,False,AAAAAAAAHHHHHHHHHHHH,20
2550,886187223229632512,2017-07-15 11:34:33,6,2,8,False,AAAAAAAAHHHHHHHHHHHHHH,22
2551,886184865841983489,2017-07-15 11:25:11,2,0,2,True,@electricland AAAAAAHHHHHH,26
2552,886184709939703808,2017-07-15 11:24:34,3,0,3,False,AAAAAHHHHH,10
2553,886182192828887040,2017-07-15 11:14:33,5,1,6,False,AAAAAHHHHHHHHHHH,16
2554,886179676435230720,2017-07-15 11:04:33,8,4,12,False,AAAAAAAAAAAAAAHHHHHHHHHHHHH,27
2555,886177154857357312,2017-07-15 10:54:32,8,2,10,False,AAAAAAAAAAAHHHHHHHHHHHH,23
2556,886174641538162688,2017-07-15 10:44:33,6,2,8,False,AAAAAAAAAAAHHHHHHHHHHHHHH,25
2557,886172125140267008,2017-07-15 10:34:33,7,1,8,False,AAAAAAAAAAAAAAAAAAAAHHHHHHHHH,29
2558,886169605353459713,2017-07-15 10:24:32,14,4,18,False,AAAAAAAAAAAAAAAAAAAHHHHHHHHHHHHHH,33
2559,886167093649051648,2017-07-15 10:14:33,5,1,6,False,AAAAAHHHHHHHHH,14
2560,886164574969491456,2017-07-15 10:04:33,6,1,7,False,AAAAAHHHHHHH,12
2561,886162058030579714,2017-07-15 09:54:33,6,0,6,False,AAAAAAAAAAHHH,13
2562,886159542807146496,2017-07-15 09:44:33,8,4,12,False,AAAAAAAAHHHHHHH,15
2563,886157025981456384,2017-07-15 09:34:33,3,3,6,False,AAAAAAAAAAAAAAAAHHHHHHHHHHHHH,29
2564,886154509227098112,2017-07-15 09:24:33,4,0,4,False,AAAAAAAAAAAAHHHHHHHH,20
2565,886151992044920833,2017-07-15 09:14:33,4,1,5,False,AAAAAAAAAAAAAAAHHH,18
2566,886149474590097410,2017-07-15 09:04:33,7,3,10,False,AAAAAAAAAAAAAAAAAAAHHHHHHHHH,28
2567,886146957391134720,2017-07-15 08:54:33,5,1,6,False,AAAAAAAAAAAAAAAAHHHH,20
2568,886144441668468736,2017-07-15 08:44:33,6,3,9,False,AAAAAAAAAAHHHHHH,16
2569,886141923748171776,2017-07-15 08:34:32,6,4,10,False,AAAAAAAAAAAAAAAAAAAAAAHHHHHHH,29
2570,886139409174732800,2017-07-15 08:24:33,22,9,31,False,AAAAAAAAAAAAAAAAAAAAAHHHHHHHHHHHHHH,35
2571,886136892688916480,2017-07-15 08:14:33,4,2,6,False,AAAAAAAAAAAAAAAHHHHHHHHHH,25
2572,886134376685346816,2017-07-15 08:04:33,1,1,2,False,AAAAAAAAAAAAAAAAAAAAHHHHHH,26
2573,886131857368154112,2017-07-15 07:54:32,4,0,4,False,AAAAAAAHHHHHHHHHHHHHHHH,23
2574,886129342069211137,2017-07-15 07:44:33,11,7,18,False,AAAAAAAAAAAAAAAAAHHHHHHHHHHH,28
2575,886126826443157506,2017-07-15 07:34:33,3,0,3,False,AAAAAAAAAHHHHH,14
2576,886124311702114304,2017-07-15 07:24:33,9,2,11,False,AAAAAAAAAAAAAAAAAHHHHHHHHHHHHHH,31
2577,886121791005089792,2017-07-15 07:14:32,7,1,8,False,AAAAAAAAAAAAAHHHHHHHHHH,23
2578,886120691430567938,2017-07-15 07:10:10,0,0,0,True,@NuclearAnthro AAHHHHHHHHHHHHH,30
2579,886119277832622080,2017-07-15 07:04:33,6,1,7,False,AAAAAAAAAHHHH,13
2580,886116761313083393,2017-07-15 06:54:33,7,2,9,False,AAAAAAAAHHHHHHHHHHH,19
2581,886114398795948033,2017-07-15 06:45:10,0,0,0,True,@NuclearAnthro AAAAAAAAAAAAAAAAAHHHHHHH,39
2582,886114398779187201,2017-07-15 06:45:10,0,0,0,True,@GeorgeWHerbert AAAAAAAAAAAAAHHHHHHHHHHH,40
2583,886114245011746816,2017-07-15 06:44:33,19,11,30,False,AAAAAAAAAAAAAAAAAAAAHHHHHHHHHHHHHH,34
2584,886111726198026245,2017-07-15 06:34:33,7,0,7,False,AAAAAAAAAAAAHHHHHHHHHHHHH,25
2585,886109372308496385,2017-07-15 06:25:12,3,1,4,True,"@IllegalScreens AAAAAAAAAAAAAAAAAHHHHHH 
https://t.co/RCixkFG5QR",64
2586,886109210701856769,2017-07-15 06:24:33,8,0,8,False,AAAAAAAAHH,10
2587,886106693297463296,2017-07-15 06:14:33,8,0,8,False,AAAAAAAAAAAHHHHHH,17
2588,886104176287199232,2017-07-15 06:04:33,6,1,7,False,AAAAAAHHHHHHHHHH,16
2589,886101813165993984,2017-07-15 05:55:09,1,1,2,True,@city_dick1 AAAAAAAAAAAAAAAAHHHHHHHHHHHHHHH,43
2590,886101662380806149,2017-07-15 05:54:33,12,3,15,False,AAAAHHHHHHHHHHHHHHHH,20
2591,886099144254926849,2017-07-15 05:44:33,8,1,9,False,AAAAAAAAAAAAAAHHH,17
2592,886096627206893568,2017-07-15 05:34:33,8,0,8,False,AAAAAAAAAAAHHH,14
2593,886094109819187200,2017-07-15 05:24:33,16,12,28,False,"AAAAAAAAAAHHHHHHHHHHHH 
https://t.co/cJJofLJO7W",47
2594,886091592246996992,2017-07-15 05:14:33,7,3,10,False,AAAAAAAAAAAAAHHHHHH,19
2595,886089080211111936,2017-07-15 05:04:34,5,3,8,False,AAAAAAAAAAAAAAAHHHHHHHHH,24
2596,886086559748980736,2017-07-15 04:54:33,8,0,8,False,AAAAAAAAAAAAAAAAAAAHHHHH,24
2597,886085459541188608,2017-07-15 04:50:10,0,0,0,True,@lemonygelato AAAAAAAAAHHHHHHHH,31
2598,886084042285830146,2017-07-15 04:44:32,11,5,16,False,AAAAAAAAAAAAAAAAAAAAAHHHHH,26
2599,886081529079836673,2017-07-15 04:34:33,11,6,17,False,AAAAAAAAAAAHHHHHHH,18
2600,886079009431355392,2017-07-15 04:24:33,6,2,8,False,AHHHHHHHHHHHHHH,15
2601,886076493696311297,2017-07-15 04:14:33,10,7,17,False,AAAAAAAAAAAAAHHHHHHHHHHHHHHH,28
2602,886073980049928193,2017-07-15 04:04:33,12,8,20,False,AAAAAAAAAAAAAAAAAH,18
2603,886071461118709760,2017-07-15 03:54:33,10,2,12,False,AAHHHHHHHHH,11
2604,886068946566250496,2017-07-15 03:44:33,15,5,20,False,AAHHHHHHHHHHHHHHH,17
2605,886066428197175296,2017-07-15 03:34:33,12,6,18,False,AAAAAAAAAAAHHHHHHHHHH,21
2606,886063910767534081,2017-07-15 03:24:33,5,1,6,False,AAAAAAAAAAAAAAAAHHH,19
2607,886061395107827713,2017-07-15 03:14:33,11,1,12,False,AAAAAAAAHHHHH,13
2608,886058877783080960,2017-07-15 03:04:33,11,2,13,False,"AAAAAAAAAAAAAAAAAAHHHHHHHHHHHHH 
https://t.co/deNl6Na4DJ",56
2609,886056360768671744,2017-07-15 02:54:33,9,0,9,False,AAAAHHHHHH,10
2610,886053844920262658,2017-07-15 02:44:33,16,13,29,False,AAAAAAAAAAAAAAAAAAHHHHHHHHHHHHHHHH,34
2611,886051329961054208,2017-07-15 02:34:33,10,0,10,False,AAAAAAAAAAAAH,13
2612,886048810606227458,2017-07-15 02:24:33,7,0,7,False,AAAHHHHHHHH,11
2613,886046293579231232,2017-07-15 02:14:32,9,2,11,False,AAAAHHHHHHH,11
2614,886043779358130180,2017-07-15 02:04:33,5,1,6,False,AAAAAAAAAAAAAHHHHHHHH,21
2615,886041260363980800,2017-07-15 01:54:32,17,10,27,False,AAAAAAAAAAAAAAAAHHHHHHHHHHHHHH,30
2616,886038744247259136,2017-07-15 01:44:33,13,2,15,False,AAAAAAAAAAAAAAAAAAHHHHHHHHHHH,29
2617,886036227211874304,2017-07-15 01:34:32,14,5,19,False,AAAAAAAAAAAAAAAAAAAAAAAHHHHHHHHHHHHHHHH,39
2618,886033712340709377,2017-07-15 01:24:33,10,0,10,False,AAAAAAAAAHH,11
2619,886031194802008067,2017-07-15 01:14:33,17,8,25,False,AHHHHHHHHHHHHHHH,16
2620,886028683248578561,2017-07-15 01:04:34,14,1,15,False,AAAAAAAAAAAAAHHHHHHHHHHHHHHHH,29
2621,886026162551566336,2017-07-15 00:54:33,10,1,11,False,AAAAAAAAAAAAHHHH,16
2622,886023647076470784,2017-07-15 00:44:33,11,6,17,False,AAAAAAAAAHHHHHHHHHHHHHHH,24
2623,886021129697099779,2017-07-15 00:34:33,12,5,17,False,AAAAAAAAAAHH,12
2624,886018611277701120,2017-07-15 00:24:33,23,11,34,False,AAAAAAAAAAAAAAAAAAAAAHHHHHHHHHHHHH,34
2625,886016095345418240,2017-07-15 00:14:33,7,3,10,False,AAAHH,5
2626,886013581011169280,2017-07-15 00:04:33,13,1,14,False,AAAAAAAAHHHHHHHHHHHHHH,22
2627,886011063443091456,2017-07-14 23:54:33,11,1,12,False,AAAAAAAAAAAAAAAAAAAHHHH,23
2628,886008544293789698,2017-07-14 23:44:32,7,2,9,False,AAHHHHHHHHHHHHHH,16
2629,886006029951143936,2017-07-14 23:34:33,10,1,11,False,AAAAAAAAAAHHHH,14
2630,886003513196728322,2017-07-14 23:24:33,12,3,15,False,AAHHHHHHHHHHH,13
2631,886000997050535948,2017-07-14 23:14:33,16,6,22,False,AAAAAAAAAAAAAAAAAHH,19
2632,885998482619854851,2017-07-14 23:04:33,9,2,11,False,AAAAAAAHHHHHHHH,15
2633,885996119351840772,2017-07-14 22:55:10,0,0,0,True,@seekpedro AAAAAAAAAAAAAAAAAHHHHHHHHHHHHHHH,43
2634,885995961713139712,2017-07-14 22:54:32,20,4,24,False,AAAAAAAAAAAAAAAAAAAHHHHHH,25
2635,885993446506467332,2017-07-14 22:44:33,11,0,11,False,AAHHHHHHHHHHHHH,15
2636,885990929693323264,2017-07-14 22:34:33,21,5,26,False,AAAAAAAAAAAAAAAAAAAAAAHHHHHHHHHHH,33
2637,885988412347625472,2017-07-14 22:24:33,18,5,23,False,AAAAAAAAAAAAAAAAAAAAAAHH,24
2638,885987314043940864,2017-07-14 22:20:11,1,0,1,True,@LittleTomatillo AAAAAAAAAAAAAAAAAAAAAAAH,41
2639,885987314039750657,2017-07-14 22:20:11,0,0,0,True,@Barbara_Wms AAAAAAAAAAAAHHHHHHHHHHH,36
2640,885985895874277377,2017-07-14 22:14:33,15,3,18,False,AAAH,4
2641,885983380323565569,2017-07-14 22:04:33,9,0,9,False,AAAAAAAHHHHHHHHHH,17
2642,885980863539941381,2017-07-14 21:54:33,6,1,7,False,AAAAAAAAAAAAHHHHHHHHHHH,23
2643,885978347028795397,2017-07-14 21:44:33,12,2,14,False,AAAAAHHHHHHHHHHHHHH,19
2644,885975830995894272,2017-07-14 21:34:33,14,0,14,False,AAAAAAAAAAAAAAAAAAAAAHHHHHHHHHHHHHHH,36
2645,885973313834676225,2017-07-14 21:24:33,13,2,15,False,AAAAAAAAAAAAAAAAHHHHH,21
2646,885970799710138371,2017-07-14 21:14:33,11,2,13,False,AAAAAAAAAHHHHHHH,16
2647,885968438035927041,2017-07-14 21:05:10,0,0,0,True,@defectiveMom AAAAAAAAAAAAAAAAAAAAAAAHH,39
2648,885968283249389569,2017-07-14 21:04:33,9,3,12,False,AAAAAAAAAAHHHHH,15
2649,885965763173109760,2017-07-14 20:54:33,11,1,12,False,AHHHHHHHHHHHHHH,15
2650,885964670418505729,2017-07-14 20:50:12,1,0,1,True,@Jen949806 AAAAAAHHHHHHHHHHHHHH,31
2651,885963247341490176,2017-07-14 20:44:33,10,4,14,False,AAAAAAAAAAAAHHHHHHHH,20
2652,885960731849633793,2017-07-14 20:34:33,15,2,17,False,AAAAAAAAAAAAAAAAAAAAAHHHHHHHHH,30
2653,885958216533889025,2017-07-14 20:24:33,24,10,34,False,AAAAAAAAAAAAAAAAAAAHHHHHHHHH,28
2654,885955699594887168,2017-07-14 20:14:33,18,3,21,False,AAAAAAAAAAAAAAAAAAAAAHHHHHHHHHHHH,33
2655,885953182588952576,2017-07-14 20:04:33,10,1,11,False,AAHHHHHHHHHH,12
2656,885950663405993984,2017-07-14 19:54:32,9,1,10,False,AAAAAAAAAAAAAAAAAAHHH,21
2657,885948148123926529,2017-07-14 19:44:33,20,7,27,False,AAAAAAAHHHH,11
2658,885945632766255105,2017-07-14 19:34:33,11,2,13,False,AAHHHH,6
2659,885943117421084673,2017-07-14 19:24:33,15,3,18,False,AAAAAAAAAAHHHHHHHHHHHHHH,24
2660,885940600171880454,2017-07-14 19:14:33,8,1,9,False,AAAAAAHHHHHHHHHH,16
2661,885938085514620928,2017-07-14 19:04:34,13,2,15,False,AAAAAAAAAHHHHHHHHHHHHHH,23
2662,885935566222745600,2017-07-14 18:54:33,9,2,11,False,AAAAAAHHHHH,11
2663,885933050978340867,2017-07-14 18:44:33,14,2,16,False,AAAAAAAAAAAAAAAAHHHHHHHHHH,26
2664,885930533859057664,2017-07-14 18:34:33,10,2,12,False,AAAAAAAAAAAAAHH,15
2665,885928016655921152,2017-07-14 18:24:33,14,2,16,False,AAAAAAAAAAAAAAAAAHHHHHHHHHHHHHHHH,33
2666,885925501411500036,2017-07-14 18:14:33,6,2,8,False,AAAAAHHH,8
2667,885922984124448769,2017-07-14 18:04:33,10,2,12,False,AAAAAAAAAAAAAAAAAAAHHHHH,24
2668,885920466552205313,2017-07-14 17:54:33,12,1,13,False,AAAAAAAAAHHHHH,14
2669,885917948321435648,2017-07-14 17:44:33,15,8,23,False,AAAAAAAAAAAAAAAAAAAHHHHHHHHHHHHH,32
2670,885915431277559808,2017-07-14 17:34:32,10,2,12,False,AAAHHHHHHHHHHH,14
2671,885912916175835137,2017-07-14 17:24:33,8,3,11,False,AAAAHHHHHHHHHHHHHHH,19
2672,885910399824080897,2017-07-14 17:14:33,10,1,11,False,AAHHHHHHHHHHHH,14
2673,885907882209931264,2017-07-14 17:04:33,9,5,14,False,AAAAAAAAAAAAAAAAAAHHHHHHHHHHHHHHH,33
2674,885906790583500801,2017-07-14 17:00:12,1,0,1,True,@trochee AAAAH,14
2675,885905368324460545,2017-07-14 16:54:33,9,2,11,False,AAAHHHHHH,9
2676,885903007371714560,2017-07-14 16:45:10,0,0,0,True,@awptimus AAAAAAHHHHHHHHHH,26
2677,885902848214663168,2017-07-14 16:44:32,16,2,18,False,AAAAAAAAAAAAHHH,15
2678,885900332819247104,2017-07-14 16:34:33,18,5,23,False,AAAAAAAAAAAAAAAAAAHHHHHHHHHH,28
2679,885897816949891076,2017-07-14 16:24:33,7,2,9,False,"AAAAAAAAAAAAAAHH 
https://t.co/RCixkFG5QR",41
2680,885895302292676608,2017-07-14 16:14:33,10,3,13,False,AAAAAAAAAAAHHHHHHH,18
2681,885892786033184769,2017-07-14 16:04:33,12,1,13,False,AAAAAAAAAAAAAHHHHHHHHHHHH,25
2682,885890423478251523,2017-07-14 15:55:10,0,0,0,True,@Mpeyman01 AAAAAAAAAAAAAAAAAAAHHHHHHHHH,39
2683,885890266229551105,2017-07-14 15:54:33,5,0,5,False,AHHHH,5
2684,885887907478863872,2017-07-14 15:45:10,0,0,0,True,@mojgan_fr AAAAAAAAAAAAAAAAAAAAAAAHHH,37
2685,885887752876720128,2017-07-14 15:44:33,17,3,20,False,AAAAAAAAAAAAAAAAAAAHHHHHHHHHHHHHHHH,35
2686,885886657240727553,2017-07-14 15:40:12,0,0,0,True,@Mpeyman01 AAAAAAAAAAAAAAAAAAAHHHH,34
2687,885886657211363328,2017-07-14 15:40:12,0,0,0,True,@Mpeyman01 AAAAAAHHH,20
2688,885886657144270848,2017-07-14 15:40:12,0,0,0,True,@mojgan_fr AHHHHHHHHH,21
2689,885886657131683840,2017-07-14 15:40:12,1,0,1,True,@mojgan_fr AAAAAAAAAHHHHHHH,27
2690,885885236944437250,2017-07-14 15:34:34,15,5,20,False,AAAAAAAAAAAAAAAAAAAAHHHHHHHHHHHHHHH,35
2691,885882716947984384,2017-07-14 15:24:33,13,3,16,False,AAAAAAAAAAAAAAAAAAAHHHHHHHHHHHHHH,33
2692,885881618849771520,2017-07-14 15:20:11,0,0,0,True,@_rezrez_ AAAAAHHHHHHHHHH,25
2693,885880199379910656,2017-07-14 15:14:33,10,1,11,False,"AAAAAAAAAAAAAAAAAAHHHHHHHH 
https://t.co/RCixkFG5QR",51
2694,885877683908947968,2017-07-14 15:04:33,20,4,24,False,AAAAAAAAAAAAAAAAAAAAAAHHH,25
2695,885875165837524992,2017-07-14 14:54:32,15,3,18,False,AAAAAAAAAAAAAAAAAAAAHHHHHHH,27
2696,885872649863405570,2017-07-14 14:44:33,11,6,17,False,AAAAAAAAAAAAAAAAAAAAAHHHHHHHHHHH,32
2697,885870132718972928,2017-07-14 14:34:32,8,1,9,False,AAAAAAAAAAAAAAHHH,17
2698,885867619437424640,2017-07-14 14:24:33,20,10,30,False,AAAAAAAAAAAAAAAAAAAAAAHHHHHHHHHHHHHH,36
2699,885865257440292865,2017-07-14 14:15:10,0,0,0,True,@MRRP013 AAAAAAAAAAAAHHHHH,26
2700,885865101517094912,2017-07-14 14:14:33,14,4,18,False,AAAAAAAAAAAAAAAAAAHHHHHHHHHHHHHH,32
2701,885864005520248832,2017-07-14 14:10:12,0,0,0,True,@mojgan_fr AAAAAAAAAAAAAAAAHHHHHHHH,35
2702,885862584825597952,2017-07-14 14:04:33,6,1,7,False,AAAAHHHHHHHHHHHH,16
2703,885860066510991361,2017-07-14 13:54:32,6,3,9,False,AAAAAAAAHHHHHHHHHHH,19
2704,885857550348013568,2017-07-14 13:44:33,22,11,33,False,AAAAAAAAAAAAAAAAAAAAHHHHHHHHHHHH,32
2705,885855033329430531,2017-07-14 13:34:32,10,5,15,False,AAAAHHHHHHHHHHHHH,17
2706,885852675304288256,2017-07-14 13:25:10,0,0,0,True,@AlexFGoldberg AAAAAAAAAAAAAAAAAAHHHHHHHHH,42
2707,885852520131833856,2017-07-14 13:24:33,5,1,6,False,AAAAAHH,7
2708,885850003759144960,2017-07-14 13:14:33,13,5,18,False,AAAAAAAAAAAAAAAAHHHHH,21
2709,885847642256920576,2017-07-14 13:05:10,1,0,1,True,@defectiveMom AAAAAAAAAAAAAAAAHH,32
2710,885847489257115648,2017-07-14 13:04:34,6,3,9,False,AAAAAAHHH,9
2711,885844969088593921,2017-07-14 12:54:33,8,3,11,False,AAAAAAAAHHHHHHHHHHHH,20
2712,885842452934000640,2017-07-14 12:44:33,14,7,21,False,AAAAAAAAAAAAAAAAAAAAAAAHHHHHHH,30
2713,885839936645189633,2017-07-14 12:34:33,9,7,16,False,AAAAAAAAAAAHHHHHHHHH,20
2714,885837420339634176,2017-07-14 12:24:33,6,2,8,False,AAAAAAAAAAAAHHHHHHHHHHHH,24
2715,885834901282574337,2017-07-14 12:14:33,14,7,21,False,AAAAAAAAAAAAAAAAAAAAAAHHHHHHHHHHHHHHHH,38
2716,885832384364642304,2017-07-14 12:04:33,15,4,19,False,AAAAAAAAH,9
2717,885829866557517828,2017-07-14 11:54:32,8,2,10,False,AAAAAAAAAAAAAAAAHHHHHH,22
2718,885827354278473728,2017-07-14 11:44:33,7,3,10,False,AHHHH,5
2719,885824836869787648,2017-07-14 11:34:33,6,0,6,False,AAAAAAHHHHHHHHHHH,17
2720,885822321323372544,2017-07-14 11:24:33,21,5,26,False,AAAAAAAAAAAAAAAAAAAAAAAHHHHHHHH,31
2721,885819800970285057,2017-07-14 11:14:32,7,4,11,False,AAAAAAAAAAAAAAHHHHHHHHHHHHHH,28
2722,885817288607367168,2017-07-14 11:04:33,4,1,5,False,AAAAAAAAAAAAAAAHHHHH,20
2723,885814928560586752,2017-07-14 10:55:11,1,0,1,True,@TheOneBrack AAAAAAAAAAAAAAAAAAAAAHHHHHHHHH,43
2724,885814769101537280,2017-07-14 10:54:33,6,0,6,False,AAAAAAAAAAAHHHHHHHHHHHHHH,25
2725,885812255387996160,2017-07-14 10:44:33,8,3,11,False,AAAAAAAAAAAAAAAAAAAAAHHHHHHH,28
2726,885809736754622464,2017-07-14 10:34:33,4,3,7,False,AAAAAAAAAAHHHHHHHHHHHHHHHH,26
2727,885807375298506752,2017-07-14 10:25:10,0,0,0,True,@saltymomorency AAAAAAAAAAAAAAAAAAAHHH,38
2728,885807221266931712,2017-07-14 10:24:33,8,3,11,False,AAAAAAAAAAAAAAAAAAAHHHHHHH,26
2729,885804704080547840,2017-07-14 10:14:33,11,5,16,False,AAAAAAAAAAAAAAAAAAAAAAHHHHHHHHH,31
2730,885802345224957953,2017-07-14 10:05:11,0,0,0,False,@waringlunatic AAAAAAAAAAAAAAAAAAHHHHHHH,40
2731,885802186692845569,2017-07-14 10:04:33,7,5,12,False,AAAAAAAAAAAAAAAAAAAAHHHHHHHHH,29
2732,885801096970719232,2017-07-14 10:00:13,0,0,0,False,@waringlunatic AAAAAAAAAAAAAAAAAAHHH,36
2733,885801096958144512,2017-07-14 10:00:13,0,0,0,False,@waringlunatic AAAAHHHHHHHHHHHHH,32
2734,885799669506375680,2017-07-14 09:54:33,4,1,5,False,AAAAH,5
2735,885797152789860354,2017-07-14 09:44:33,13,1,14,False,AAAAAAAAAAAAAAAAH,17
2736,885794638648496128,2017-07-14 09:34:33,2,2,4,False,AAAAAAAAHH,10
2737,885792122376519680,2017-07-14 09:24:33,3,1,4,False,AAAAAHHHHHH,11
2738,885789606515552257,2017-07-14 09:14:34,7,3,10,False,AAAAAAAAAAAAAAAAAHHH,20
2739,885787088024735744,2017-07-14 09:04:33,3,0,3,False,AAAAAAAAAAAHH,13
2740,885784568711741440,2017-07-14 08:54:32,2,1,3,False,AAAAAAHH,8
2741,885782055166103553,2017-07-14 08:44:33,2,1,3,False,AAAAAAAAAAAHHHH,15
2742,885779537019244544,2017-07-14 08:34:33,6,3,9,False,AAAHHHHHHHHHHHHHHH,18
2743,885777019635732480,2017-07-14 08:24:33,3,2,5,False,AHH,3
2744,885774502730375169,2017-07-14 08:14:33,14,4,18,False,AAAAAAAAAAAAAAAAAAAAHHHHHHHHHHHHHHHH,36
2745,885772145716076546,2017-07-14 08:05:11,1,0,1,True,@caveatsnsuch AAAHHHHHHHHHHHHHHH,32
2746,885771987636944896,2017-07-14 08:04:33,6,0,6,False,AAHHHHHHHHHHH,13
2747,885769469066399745,2017-07-14 07:54:32,9,2,11,False,AAAAAAAAAAAAAHHHHHHHHHHHHHHHH,29
2748,885766954119725056,2017-07-14 07:44:33,5,0,5,False,AAAAAHHHHHHHHHH,15
2749,885764437252157442,2017-07-14 07:34:33,7,1,8,False,AHHHHHHHHHH,11
2750,885761919600263168,2017-07-14 07:24:32,5,1,6,False,AAAAAAAAAAHHHHHHHHHHHHH,23
2751,885759407145058304,2017-07-14 07:14:33,8,3,11,False,AAAAAAAAAAAAAAAAAAAHHHHHHHHH,28
2752,885756891384741888,2017-07-14 07:04:34,8,1,9,False,AAAAAAAAAAAAAAAAAAAAAHH,23
2753,885754373015556096,2017-07-14 06:54:33,4,2,6,False,AAAAAAAAAAAAAAAHHHHHHHHHH,25
2754,885751854491152384,2017-07-14 06:44:33,4,0,4,False,"AAAAAAAAAAHHHHHHHHHH 
https://t.co/h23hgBJBeD",45
2755,885749340266004481,2017-07-14 06:34:33,10,1,11,False,AAAAAAAAAHHHHHHHHHHHH,21
2756,885746821292863488,2017-07-14 06:24:33,10,4,14,False,AHHHHH,6
2757,885744306094571520,2017-07-14 06:14:33,7,1,8,False,AAAAAAAAAAAAAAAAAAH,19
2758,885741787746271232,2017-07-14 06:04:33,15,6,21,False,AAAAAAAAAAAAAAAHHHHHHHHH,24
2759,885740691690803201,2017-07-14 06:00:11,0,0,0,True,@NerdyTraveler AAAAAAAAAAAAAHHHH,32
2760,885739270585155584,2017-07-14 05:54:33,9,0,9,False,AAAAAAAAAAAAAAAAHHHHHHHHHHHHH,29
2761,885736754539618306,2017-07-14 05:44:33,10,5,15,False,AHHHHHHHHHHHH,13
2762,885734237516771329,2017-07-14 05:34:33,7,0,7,False,AAAAAAAHHHH,11
2763,885731723501346817,2017-07-14 05:24:33,6,3,9,False,AAAAHHHHHHHHHHHHHH,18
2764,885729203836133380,2017-07-14 05:14:32,13,1,14,False,AAAAAAAAAAAAAAAAAAAAAAHHHHHHHHHHHHHH,36
2765,885726691280158720,2017-07-14 05:04:33,8,0,8,False,AAAAAAAAAAAAAAAAAAAAHHHH,24
2766,885724326418403328,2017-07-14 04:55:10,0,0,0,True,@stuxnetsource AAAAAAAAAAHHHH,29
2767,885724326359691264,2017-07-14 04:55:10,0,0,0,True,@stuxnetsource AAAAAAHHHHHHHHHHH,32
2768,885724171812122624,2017-07-14 04:54:33,14,6,20,False,AAAAAAAAAAAAAAAAAHHHHHHHHHHHHHHHH,33
2769,885723071956615168,2017-07-14 04:50:10,0,0,0,True,@stuxnetsource AAAAAAAAAAAAAAAAHH,33
2770,885723071809826816,2017-07-14 04:50:10,0,0,0,True,@towittertoo AAAAAAAAAHHHHH,27
2771,885721657108725760,2017-07-14 04:44:33,8,1,9,False,AAAAAAAAAAAAAAAHHHH,19
2772,885719139800809472,2017-07-14 04:34:33,10,2,12,False,AAAAAAAAAAAAHHHHHHHHH,21
2773,885718043879497729,2017-07-14 04:30:12,0,0,0,True,@AbeaBeabE_ABE AAAAAAAAAAAAAAAHHHHHHHHHHHHHHHH,46
2774,885716622006202368,2017-07-14 04:24:33,9,1,10,False,AAHHHHHHHHHHHHHHH,17
2775,885714105579048961,2017-07-14 04:14:33,18,6,24,False,AAAAAAAAAAAAAAAAAAAAAAHHHHHHHHHHHH,34
2776,885711590955380736,2017-07-14 04:04:33,9,0,9,False,AAAAAHHHHHHHHHHHHHH,19
2777,885709072074502144,2017-07-14 03:54:33,11,5,16,False,AAAAAAAAAAAHHHHHHHH,19
2778,885706555492093954,2017-07-14 03:44:33,16,4,20,False,AAAAAAAAAAHHHHHHHHHHH,21
2779,885704039715004419,2017-07-14 03:34:33,10,3,13,False,AAAAHHHHH,9
2780,885701524172754945,2017-07-14 03:24:33,11,1,12,False,AAAAAAAAAAAAAAHHHHH,19
2781,885699004578877444,2017-07-14 03:14:32,8,2,10,False,AAAHHHHHHH,10
2782,885696489917468672,2017-07-14 03:04:33,19,10,29,False,AAAAAAAAAAAAAAAAAAAAHHHHHHHHHHHHHH,34
2783,885695395245981702,2017-07-14 03:00:12,1,0,1,True,@NobodyExpects13 AAAAAAAAAAAAAAAAAAAAAHHHHHHHHHH,48
2784,885695395245981701,2017-07-14 03:00:12,0,0,0,True,@quietsongstress AAAAAAAAAAAAAAAAAAHHHHHHHHHHHHHHH,50
2785,885693972630384641,2017-07-14 02:54:33,10,1,11,False,AAAAAAAAHHHHH,13
2786,885692873206890496,2017-07-14 02:50:11,1,0,1,True,@BlueLarsen AAAAAAAAAAAAAAAAAAAAAAAHHHHHHH,42
2787,885692873152356353,2017-07-14 02:50:10,1,0,1,True,"@JustinTrJackson AAAAAAAAAAAAAAHH 
https://t.co/h23hgBJBeD",58
2788,885691458786910208,2017-07-14 02:44:33,36,7,43,False,AH,2
2789,885689097280524288,2017-07-14 02:35:10,1,0,1,True,@quietsongstress AAHHHHHHH,26
2790,885689097276334080,2017-07-14 02:35:10,0,0,0,True,@quietsongstress AAAAAAAAAAAAAAAAHHHHHHHHHHHHHHHH,49
2791,885688939213983745,2017-07-14 02:34:33,9,0,9,False,AAAAAAAAAHHH,12
2792,885686424598708224,2017-07-14 02:24:33,12,5,17,False,AAAAAAHHHHHHHHHHHHHHHH,22
2793,885683904958668800,2017-07-14 02:14:32,6,2,8,False,AAAAAAAHHHHH,12
2794,885681391882711040,2017-07-14 02:04:33,14,5,19,False,AAAAAAAAAAAHHHHHHHHHH,21
2795,885678872469098496,2017-07-14 01:54:32,10,4,14,False,AAAAAAAAAAAAAAHHHHHHHHHH,24
2796,885676356029358081,2017-07-14 01:44:33,4,0,4,False,AAAAAAAAAHH,11
2797,885673840021573633,2017-07-14 01:34:33,20,7,27,False,AAAAAAAAAAAAAAAAAAAAAAAHHHHHHHHHHHHHHHH,39
2798,885671325527941120,2017-07-14 01:24:33,8,5,13,False,AAAAAAAAAAAAAAAAAAAAAAHHHHH,27
2799,885670229136879616,2017-07-14 01:20:12,0,0,0,True,@LeifHanson7 AHHH,17
2800,885668808400281601,2017-07-14 01:14:33,14,6,20,False,"AAAAAAHHHHHH 
https://t.co/cJJofLJO7W",37
2801,885666294682574852,2017-07-14 01:04:34,10,2,12,False,AAAAAAAAAAAAAAAAAHHHHHHHHHHHH,29
2802,885663773364715520,2017-07-14 00:54:33,20,11,31,False,AAAAAAAAAAAAAAAAAAAAHHHHHHHHHH,30
2803,885661258594365440,2017-07-14 00:44:33,4,0,4,False,AAAAAAAAHHHHHH,14
2804,885658742632665088,2017-07-14 00:34:33,9,5,14,False,AAAAAAAAAAAAAAAAAAHH,20
2805,885656223139463168,2017-07-14 00:24:32,5,2,7,False,AAAAHHHHHH,10
2806,885653865072381952,2017-07-14 00:15:10,0,0,0,True,@mikefleisch AAAAAHHHHH,23
2807,885653707949473792,2017-07-14 00:14:33,9,6,15,False,AAAAAAAAHHHHHHHHH,17
2808,885651190759002113,2017-07-14 00:04:33,6,1,7,False,AAAAAAAAAAAAAHHHHHHHHHH,23
2809,885648673920741378,2017-07-13 23:54:33,8,4,12,False,AAAAAAAAAAAHHHHHHH,18
2810,885646160131743745,2017-07-13 23:44:33,8,1,9,False,AAAAHH,6
2811,885643641074716672,2017-07-13 23:34:33,6,0,6,False,AAAAAAAAAAAAAAAAAHHHHHHHHHH,27
2812,885641125037572096,2017-07-13 23:24:33,10,1,11,False,AAAAAAAAAAHHHHHHHHHHHHHHH,25
2813,885638610023854080,2017-07-13 23:14:33,14,2,16,False,AAAAAAAAAAAAAAAAAHHHHHHHHHHHHHH,31
2814,885636090882908162,2017-07-13 23:04:33,16,8,24,False,AAAAAAAAHHHHHHHHHHHHHH,22
2815,885633575474913280,2017-07-13 22:54:33,5,3,8,False,AAAAAAHHH,9
2816,885631058871545858,2017-07-13 22:44:33,6,4,10,False,AAAAAAAAAAAAAHHHH,17
2817,885628542972776448,2017-07-13 22:34:33,11,2,13,False,AAAAAAAAAAHHHHHHHHH,19
2818,885626181739048961,2017-07-13 22:25:10,0,0,0,True,@bethfiegerfalk AAAAAAAAAAAAAAAAAAAHHHHH,40
2819,885626181697114114,2017-07-13 22:25:10,1,0,1,True,@Mariaiorl AAAAAAAAAAAAAAAAAAAAAAAHHH,37
2820,885626024901439491,2017-07-13 22:24:33,6,2,8,False,AAAAAAAAAAHH,12
2821,885623509736718336,2017-07-13 22:14:33,13,6,19,False,AAAAAAAAAAAAAAAHHHHHHHHHHH,26
2822,885620995306004483,2017-07-13 22:04:33,9,3,12,False,AAAAAAAAAAAHHHHHHHHHHHH,23
2823,885618632943968257,2017-07-13 21:55:10,0,0,0,True,@Ali_Davis AAAAAAAAHHH,22
2824,885618632927182848,2017-07-13 21:55:10,0,0,0,True,@amyignatow AAAAAAAAHHHHHHHHHHHH,32
2825,885618475808546816,2017-07-13 21:54:33,8,0,8,False,AAAAAH,6
2826,885617377869799424,2017-07-13 21:50:11,1,0,1,True,@amyignatow AAAAAAAAAAAAAAAAAAAAHHHHHHHHHHHHHHHH,48
2827,885617377848815616,2017-07-13 21:50:11,1,0,1,True,@Change2day2Tomo AAAAAAAAAAAAAAAAAAHHHHHH,41
2828,885615961382023169,2017-07-13 21:44:33,11,2,13,False,AAAAAHHHHHHH,12
2829,885613441670676484,2017-07-13 21:34:33,12,3,15,False,AAAAAAAAAAAAAAAAAAAAAAAHH,25
2830,885610927701319681,2017-07-13 21:24:33,8,3,11,False,AAAHHHHH,8
2831,885608410225496064,2017-07-13 21:14:33,8,2,10,False,AAAAAAAHH,9
2832,885606050640089089,2017-07-13 21:05:10,0,0,0,True,@mki_mom AAAAAAAAAAHHHHHHHHHHHHHHHH,35
2833,885605894922350592,2017-07-13 21:04:33,14,2,16,False,AAAAAAAAAAAAAAAAH,17
2834,885603379275341824,2017-07-13 20:54:33,10,3,13,False,AAAAAAAAAAAAAHHHHHHHHHHHH,25
2835,885600859249356800,2017-07-13 20:44:33,8,1,9,False,AAAAAHH,7
2836,885599761516179456,2017-07-13 20:40:11,2,0,2,True,@BoobPunchTina AAAAAAAAAAHHHHH,30
2837,885598344663506944,2017-07-13 20:34:33,14,2,16,False,AAAAAAAAAAAAAAAAAAAAAHHHHHHHHHHHH,33
2838,885595826923458561,2017-07-13 20:24:33,10,5,15,False,AAAAAAAAAAAAAAAAAAAHHHHHHH,26
2839,885593308910817281,2017-07-13 20:14:33,13,5,18,False,AAAAAAAAAAAAAAAAAAAAAAHHH,25
2840,885590950554337281,2017-07-13 20:05:10,0,0,0,True,@Cacophonic AAAAAAAHHHHHHHHH,28
2841,885590792055791617,2017-07-13 20:04:32,5,1,6,False,AAAAAAAAAAAAAAAAAAHHHHHHHHHHHHHHHH,34
2842,885589697929633792,2017-07-13 20:00:12,2,0,2,True,@Cacophonic AAAAAAAAAHHHHHHHHHH,31
2843,885589697912811522,2017-07-13 20:00:12,0,0,0,True,@PaulRKendall AAAAAAAAAAAAAAAAAAAAAHHHHHHHHHHH,46
2844,885588275557216256,2017-07-13 19:54:32,14,3,17,False,AAHH,4
2845,885585762003156992,2017-07-13 19:44:33,13,4,17,False,AAAAAAAAAAAAAAAAAAAAAAHHHHHHHHH,31
2846,885583243185201153,2017-07-13 19:34:33,12,2,14,False,AAAAAHHHHHHHHHH,15
2847,885580727500328962,2017-07-13 19:24:33,13,3,16,False,AAAAAAAAAAAAAHHHHHH,19
2848,885579630312345600,2017-07-13 19:20:11,0,0,0,True,@__redcat AAAAAAAAAAAAAAAAAAAAAAHHHHHHHHHH,42
2849,885578212335644672,2017-07-13 19:14:33,8,4,12,False,AAAAAAAAAAAHHHHHHHHHHHHHH,25
2850,885575850938249217,2017-07-13 19:05:10,1,0,1,True,@Outroupistache1 AHHHHHHHHHHHHHHHH,34
2851,885575699347759108,2017-07-13 19:04:34,9,2,11,False,AHHHHHHHHHHHHHH,15
2852,885573175433711616,2017-07-13 18:54:32,12,2,14,False,AAAAAAAHHH,10
2853,885572078069571586,2017-07-13 18:50:11,1,0,1,True,@ewsiii AHH,11
2854,885572077977206784,2017-07-13 18:50:11,0,0,0,True,@Lutinhas202 AAAAAAAAAAAAAAAAAHHHHHHHHHH,40
2855,885572077973118977,2017-07-13 18:50:11,0,0,0,True,@phoutz AAAAAAAAAAAHHHHHHHHHHHHHH,33
2856,885570663020470273,2017-07-13 18:44:33,18,10,28,False,AAAAAAAAAAAAAAAAAAAAAAH,23
2857,885569565240983553,2017-07-13 18:40:12,0,0,0,True,@tee62 AAAAAAAAAAAAAAAAAAAHHHHHHHHH,35
2858,885568302541672448,2017-07-13 18:35:11,0,0,0,True,@Draconis1999 AAAAAAAAAAAAAAAAAAAHHHHHHHHHHHHHHH,48
2859,885568143913091073,2017-07-13 18:34:33,10,3,13,False,AAAAAAHHHHHHH,13
2860,885565627385171973,2017-07-13 18:24:33,14,1,15,False,AAAAAAAAAAAAAAAAAAHHHHHHHHHH,28
2861,885563110358233089,2017-07-13 18:14:33,6,0,6,False,AAAAAAAAH,9
2862,885560594472062976,2017-07-13 18:04:33,8,1,9,False,AAAAAHHHHHH,11
2863,885558079416414208,2017-07-13 17:54:33,11,2,13,False,AAAAAAAAAAAAAAAAAAAAH,21
2864,885555561588248576,2017-07-13 17:44:33,15,6,21,False,AAAAAAAAAAAAAAAAAAAAHHHHHHH,27
2865,885553045106556928,2017-07-13 17:34:33,6,2,8,False,"AAHHHHHHHHHH 
https://t.co/cJJofLJO7W",37
2866,885550526447968256,2017-07-13 17:24:32,8,4,12,False,AAAAAAAAAAAAAAAAAHHHHHH,23
2867,885548013044805633,2017-07-13 17:14:33,15,4,19,False,AAAAAAAAAAAAHHHHHHHHHHHHHHH,27
2868,885545494453379072,2017-07-13 17:04:33,8,1,9,False,AAAAAAHHHHHHHHHHHH,18
2869,885544405767262208,2017-07-13 17:00:13,1,1,2,True,@petgarsar AAHH,15
2870,885542978885955590,2017-07-13 16:54:33,11,2,13,False,AAAAAAAAAAAAAAAAAHHHHHHHHHHHHHHHH,33
2871,885540619338305537,2017-07-13 16:45:10,0,0,0,True,@tee62 AAAAAAAAAAAHHHHHH,24
2872,885540463712890882,2017-07-13 16:44:33,11,3,14,False,AAAAAAAAAAAAAAAAAHHHHHHHHH,26
2873,885537947755446272,2017-07-13 16:34:33,11,5,16,False,AAAHHHHHHHHHHHHH,16
2874,885535429868605440,2017-07-13 16:24:33,9,2,11,False,AAAAAAAAAAAAAAAHHHHH,20
2875,885532915312021504,2017-07-13 16:14:34,7,0,7,False,AAAAAAAAAAAAAH,14
2876,885530398373146624,2017-07-13 16:04:33,7,5,12,False,AAAAAAAAAAAH,12
2877,885527879072854017,2017-07-13 15:54:33,8,2,10,False,AAAAAHHHHHHHHHHH,16
2878,885525364302385152,2017-07-13 15:44:33,9,5,14,False,AAAAAAAAAAAAAAAAHHHHHHHHHHHHHH,30
2879,885522847032070145,2017-07-13 15:34:33,12,3,15,False,AAAAAAAAAAAAAAAAAAHHHHHHHHHHHH,30
2880,885520329338126337,2017-07-13 15:24:33,6,1,7,False,AAAAAAAHH,9
2881,885517812009140225,2017-07-13 15:14:33,6,1,7,False,AAAAAAAAAAAAAAAHHHHHHHHHH,25
2882,885515296911523841,2017-07-13 15:04:33,6,4,10,False,AAAAAHHHHHHHHHHHHHHHH,21
2883,885512942309048320,2017-07-13 14:55:12,0,0,0,True,@Robfraz AAAAAAAAAAAAAAAAHHHHHHHHHHHHH,38
2884,885512782141169665,2017-07-13 14:54:33,5,3,8,False,AAAAAAAAAAAAAAAHHHHHHHHHHHHHHHH,31
2885,885510425881739265,2017-07-13 14:45:12,1,0,1,True,@defectiveMom AAHHHHHHHHHHHHHHHH,32
2886,885510264262623232,2017-07-13 14:44:33,12,3,15,False,AAAAAAAAAAAAAAAAAAHHH,21
2887,885507910591275008,2017-07-13 14:35:12,1,0,1,True,@sophyish AAAAAAAAAAAAAAAAAAAAAHHHHHHHH,39
2888,885507748703727616,2017-07-13 14:34:33,11,4,15,False,AAAAAAAAAAAAAAAAAAAAAHHHHHHHHHHHHHHHH,37
2889,885506655387090945,2017-07-13 14:30:13,0,0,0,True,@chuckyoutwo AAAAAAAAAAAAAHHHHH,31
2890,885505232435904512,2017-07-13 14:24:33,8,1,9,False,AAAAAAAAAAHHHHHHHHHHHH,22
2891,885502713836048384,2017-07-13 14:14:33,8,2,10,False,AAAAHHHH,8
2892,885500196267937792,2017-07-13 14:04:33,8,5,13,False,AHHHHHHHHHHHHHHH,16
2893,885497681602367488,2017-07-13 13:54:33,1,3,4,False,AAAAAAAAAAAAAAAAAAAAAHHHHHHHHH,30
2894,885495165636546560,2017-07-13 13:44:33,3,0,3,False,AAAAAAAAHHHH,12
2895,885492647657447424,2017-07-13 13:34:33,7,4,11,False,AAAAAAAAAAAAAHHHHHHHH,21
2896,885490132777918464,2017-07-13 13:24:33,3,1,4,False,AAAAAAAAAAAAHHHHHH,18
2897,885487777206370305,2017-07-13 13:15:12,1,0,1,True,@BP_Diamond AAAAAAAAAAAAAAAAAAAAAAAHHHHHHHHHHHHHH,49
2898,885487614412894209,2017-07-13 13:14:33,21,9,30,False,AAAAAAAAAAAAAAAHHHHHHHHHHHHHH,29
2899,885485101873852416,2017-07-13 13:04:34,13,6,19,False,AAAAAAAAAAAAAAAAAAAAAAAHHHHHHHHHHH,34
2900,885482579151003652,2017-07-13 12:54:32,7,2,9,False,AAAAAAAAAAAAHHHHHHHHH,21
2901,885480064208515072,2017-07-13 12:44:33,8,1,9,False,AAAAAAAAAAAAAAHHHHHHHHHHHHHHH,29
2902,885477548930600961,2017-07-13 12:34:33,8,1,9,False,AAAAAAAHHHHHHHHHHHHHH,21
2903,885475033967206400,2017-07-13 12:24:34,10,1,11,False,AAAAAAAAAAAAAAAAAAAHHHHHHHHHH,29
2904,885472514427768832,2017-07-13 12:14:33,8,3,11,False,AAHHHHHHHHHHHHHHHH,18
2905,885469999074336768,2017-07-13 12:04:33,8,0,8,False,AAAAAAAHHHHHHHHHHHHH,20
2906,885467480268959744,2017-07-13 11:54:33,12,0,12,False,AAAAAAAAAHHHHHHHHH,18
2907,885464967151054850,2017-07-13 11:44:33,6,0,6,False,AAAAAAAAAAAAAAAHHHHHHHHHHHHHHH,30
2908,885462451424288768,2017-07-13 11:34:34,11,1,12,False,AAAAAAAAAAAAHHHHHHH,19
2909,885459933008998401,2017-07-13 11:24:33,4,0,4,False,AAAHHHHHHHHHHHH,15
2910,885457416296574976,2017-07-13 11:14:33,2,0,2,False,AAHHHHHHHHHH,12
2911,885454900196515841,2017-07-13 11:04:33,7,1,8,False,AAAAHHHHHHHHHHHH,16
2912,885452384599773185,2017-07-13 10:54:34,7,0,7,False,AAAAAAAAAAAAAAAAHHHHHHHHHHHHH,29
2913,885449867539218432,2017-07-13 10:44:33,5,1,6,False,AAAAAAAAAAAAAAAAAAAHHH,22
2914,885447351426576385,2017-07-13 10:34:34,10,2,12,False,AAAAAAAHHHHHHHHHHHH,19
2915,885444832948256768,2017-07-13 10:24:33,2,0,2,False,"AAAAAAAAAAAAAAAAAAAAAHHHHHHH 
https://t.co/cJJofLJO7W",53
2916,885442317808791553,2017-07-13 10:14:33,6,0,6,False,AAAAAAAAAAAAAAAAAAHHHHHHHH,26
2917,885439800827891712,2017-07-13 10:04:33,7,0,7,False,AAAAAAAAHHHHHHHHHH,18
2918,885437281628282880,2017-07-13 09:54:33,16,7,23,False,AAAAAAAAAAAAAAAAAAAAAAHHHHHHHHHHHHHHHH,38
2919,885434764798382080,2017-07-13 09:44:33,5,2,7,False,AAAAAAHHHHHHHHHHH,17
2920,885433670537969664,2017-07-13 09:40:12,0,0,0,True,@Plumenvahseh AAAAAAAAAAAAAAAAAAAHHHHHHHHH,42
2921,885432250665402368,2017-07-13 09:34:33,13,7,20,False,AAAAAAAAAAAAAAAAAAAAAAHHHHHHHHHHHHHH,36
2922,885431159420792832,2017-07-13 09:30:13,0,0,0,True,@sasigutierrez AAAAAAAAAAAAAAAAAAAH,35
2923,885429733969842176,2017-07-13 09:24:33,3,0,3,False,AAAAAAAAAAAAAAAAAAAAHHHHHHHHHH,30
2924,885427215105757184,2017-07-13 09:14:33,4,0,4,False,AAAAAAAAAAAAAAAAAAHHHHHHH,25
2925,885424699265757188,2017-07-13 09:04:33,2,1,3,False,AAAHHH,6
2926,885422181144031232,2017-07-13 08:54:32,8,3,11,False,AAAAHHHHHHHHHHH,15
2927,885419667032068096,2017-07-13 08:44:33,6,1,7,False,AAHHHHH,7
2928,885417151494070272,2017-07-13 08:34:33,9,4,13,False,AAAAAAAAAAAAAAAAAHHHHHHHHHHHHHHH,32
2929,885414633510756352,2017-07-13 08:24:33,15,2,17,False,AAAAAAAAAAAAAAAAAAAAAAAHHHHH,28
2930,885412117674946563,2017-07-13 08:14:33,13,3,16,False,AAAAAAAAAAAAAAAAAAAAAHHHHHHHHHHHH,33
2931,885409602443128833,2017-07-13 08:04:33,7,0,7,False,AAAAAAAAAAAAAAHHHHHHH,21
2932,885407081767079937,2017-07-13 07:54:33,16,4,20,False,AAAAAAAAAAAAAAAAAAHHHHHHHHHHHHH,31
2933,885404568040988672,2017-07-13 07:44:33,14,6,20,False,AAAAAAAAAAAAAAAHHHHHHHHH,24
2934,885402048686174208,2017-07-13 07:34:33,10,2,12,False,AAAAAAAAAAAAHHHHHHHHHHH,23
2935,885399534976864256,2017-07-13 07:24:33,9,0,9,False,AAAAAAAAAAHHHHHHHHHHHHHH,24
2936,885397019174588416,2017-07-13 07:14:33,4,1,5,False,AHHHH,5
2937,885394503334600704,2017-07-13 07:04:34,25,11,36,False,AAAAAAAAAAHHHHHHHHHHHHHHHH,26
2938,885391983870660608,2017-07-13 06:54:33,9,0,9,False,AHHHHHHHHHHHHHH,15
2939,885389466256515072,2017-07-13 06:44:33,6,1,7,False,AAAAAAHHHHHHHHHH,16
2940,885388369919963136,2017-07-13 06:40:11,0,1,1,True,@Gattinov AAAAAAAAAAAAAAAAAAAAHHHHHHHH,38
2941,885386951100178433,2017-07-13 06:34:33,4,1,5,False,AAAAAAAAHHHHHH,14
2942,885384434802884608,2017-07-13 06:24:33,9,0,9,False,AAAAAAAAAAAAAAAAAHHHHH,22
2943,885381915708198912,2017-07-13 06:14:32,10,7,17,False,AAAAAAAAAHHHHHHHHHHHHHH,23
2944,885379402321809408,2017-07-13 06:04:33,9,2,11,False,AAAAAAAAAAHHHHHHHHH,19
2945,885376882845372416,2017-07-13 05:54:33,5,0,5,False,AAAAAAAAHHH,11
2946,885374369027031041,2017-07-13 05:44:33,12,1,13,False,AAAAAAAAAAAAAAAAAAAAAAHHHHHHHHHHHH,34
2947,885371852784381952,2017-07-13 05:34:33,14,4,18,False,AAAAAAAAAAAAAAHHHHHHHHHHHHH,27
2948,885369332544548865,2017-07-13 05:24:32,11,3,14,False,AAHHHHHH,8
2949,885366818243837953,2017-07-13 05:14:33,7,1,8,False,AAAHHHHH,8
2950,885364301548093441,2017-07-13 05:04:33,11,6,17,False,AAAAAAAAAAAHHHHHHHHHHHH,23
2951,885361784521191424,2017-07-13 04:54:33,7,4,11,False,AAAAAAAAAHHHH,13
2952,885359267473174528,2017-07-13 04:44:33,13,3,16,False,AAAAAAAAAAAAAAAAAAHHHHH,23
2953,885356754208530433,2017-07-13 04:34:33,17,2,19,False,AAAAAAAAAAAAAAAAAHHHHHHH,24
2954,885354234690113536,2017-07-13 04:24:33,17,2,19,False,AAAAAAAAAAAAAAAAAAAAAAAHHHHHHHHHH,33
2955,885351716576735233,2017-07-13 04:14:32,5,2,7,False,AAAAAAAAAAAAHHHHHH,18
2956,885349201248440321,2017-07-13 04:04:33,7,5,12,False,AAAAAAHHHHHHHHHHHHHHH,21
2957,885346846264233987,2017-07-13 03:55:11,1,1,2,True,@deeshaw AAAAAAAAAAAAAAAAAAAAHHHHHHHHHHHHHH,43
2958,885346846176051200,2017-07-13 03:55:11,0,0,0,True,@gymstradamus AAAAAAAAAAAAAAAAAAAAAHHHHHHH,42
2959,885346684607266816,2017-07-13 03:54:33,7,3,10,False,AHHHHHHHHHHHHH,14
2960,885345585238245376,2017-07-13 03:50:11,1,0,1,True,@gymstradamus AAAAAAAHHHHHHHHHHH,32
2961,885344168859533314,2017-07-13 03:44:33,11,1,12,False,AAHHH,5
2962,885341652197441538,2017-07-13 03:34:33,9,0,9,False,AAAAAAAAAHHHHHHHHHHHHHHHH,25
2963,885339136223260672,2017-07-13 03:24:33,3,0,3,False,AAAAAAAAAHHHHHHHHHH,19
2964,885338038167105537,2017-07-13 03:20:11,0,0,0,True,@jaricadavis AAAAAAAHHHHHHHH,28
2965,885336619968069636,2017-07-13 03:14:33,14,3,17,False,AAAAAAAAAAAAAAAAAAAAAAAHHH,26
2966,885334102576070660,2017-07-13 03:04:33,10,2,12,False,AAAAAAAAAAAH,12
2967,885333012371705857,2017-07-13 03:00:13,0,0,0,True,@awptimus AAAAAAAAAAAAAAAAAAAAAAHHHHHHHHHHHHHHHH,48
2968,885331746945982467,2017-07-13 02:55:11,0,0,0,True,@super_mario1811 AAAAAAAAAAHHHHHH,33
2969,885331587512008709,2017-07-13 02:54:33,13,6,19,False,AAAAAAAAAAAAAAAAAAAAAHHHHHHHHH,30
2970,885329067763011585,2017-07-13 02:44:33,13,5,18,False,AAAAAAAAAAAAAAAAAAHHHHHHHHHHH,29
2971,885326551457439745,2017-07-13 02:34:33,14,4,18,False,AAAAAAAAAAAAAAAAAAAAAHHHHHHHHHHHHHH,35
2972,885324037811048449,2017-07-13 02:24:33,12,4,16,False,AAAAAAAAHHHHHHHHHHH,19
2973,885321519534137344,2017-07-13 02:14:33,12,2,14,False,AAAAAAAAAAAAHHHHHHHHHHHHHH,26
2974,885319003304058880,2017-07-13 02:04:33,12,2,14,False,AAHHHHHHHHH,11
2975,885316488118358018,2017-07-13 01:54:33,9,1,10,False,AAHHHH,6
2976,885313970583859200,2017-07-13 01:44:33,15,3,18,False,AAAAAAAAAAAAAAAAAAAAAHHHHHHHHHHH,32
2977,885311452105625602,2017-07-13 01:34:33,4,4,8,False,"AAAAAAAAAAAAAAHHHHH 
https://t.co/RCixkFG5QR",44
2978,885310359153897472,2017-07-13 01:30:12,0,0,0,True,@kyliesparks AAAAAHHHHHHHHHHHH,30
2979,885310359120293888,2017-07-13 01:30:12,1,0,1,True,@Tanya_R_Steele AAAAAAAHHHHHHHHHHHHHHHH,39
2980,885308937016401920,2017-07-13 01:24:33,13,7,20,False,AAAAAAAAAAAAAAHHHHHHHHHHH,25
2981,885306421570678784,2017-07-13 01:14:33,6,2,8,False,AAAAAHHHHHHHHHHHHHHH,20
2982,885303907387412480,2017-07-13 01:04:34,11,8,19,False,AAAAAHHHHHHHHHHH,16
2983,885301386635862017,2017-07-13 00:54:33,11,2,13,False,AAAAAAAAAHHH,12
2984,885298872305811456,2017-07-13 00:44:33,20,5,25,False,AAAAAAAAAAAAAAAAAAAAAAAHHHHHHHHHHHHHH,37
2985,885296354112700417,2017-07-13 00:34:33,24,16,40,False,AAAAAAAAAAAAAAAAAAAAHHHHHHHHHHHHHHH,35
2986,885293838209830912,2017-07-13 00:24:33,12,4,16,False,AAAAAAAHHHHHHHH,15
2987,885291322034319360,2017-07-13 00:14:33,4,0,4,False,AHHHHHH,7
2988,885288807670657024,2017-07-13 00:04:34,11,3,14,False,AAAAAAAAAAAAAAAAAAAAAHHHHH,26
2989,885286285702778881,2017-07-12 23:54:32,11,2,13,False,AAAAAAAAAAAAAHHHHHHH,20
2990,885283769711808512,2017-07-12 23:44:33,8,1,9,False,AAAAAAAAAAAAAAAAHHH,19
2991,885282672624455682,2017-07-12 23:40:11,2,1,3,True,@Reza_shell32 AAAHHHHHHHHHHH,28
2992,885281255813767169,2017-07-12 23:34:33,11,4,15,False,AAAAAAAAAHHHHHH,15
2993,885278738975510528,2017-07-12 23:24:33,11,2,13,False,AHHHHHHHHHHHH,13
2994,885276222581870592,2017-07-12 23:14:33,3,0,3,False,AAAAAAAAAH,10
2995,885273707672895488,2017-07-12 23:04:34,8,5,13,False,AAAAAAAAHHHHHHH,15
2996,885271187902824448,2017-07-12 22:54:33,7,4,11,False,AAAAAAAAAAAAAAAHHHHH,20
2997,885270090362564608,2017-07-12 22:50:11,0,0,0,True,@Bardcraft22 AAAAAAAAAAAAAAHHH,30
2998,885268672130019328,2017-07-12 22:44:33,6,1,7,False,AAAAAAAAH,9
2999,885266156864581632,2017-07-12 22:34:33,6,1,7,False,AAAAAAAAAAAAAAAAAAAAAAAHHHHHHHHHHHH,35
3000,885263638487060481,2017-07-12 22:24:33,18,7,25,False,AAAAAAAAAAAAAAAAAAAAHHHHHHHHH,29
3001,885261287567085568,2017-07-12 22:15:12,1,0,1,True,@DiaDaily AAAAAAAAHHHHHHHH,26
3002,885261121661407232,2017-07-12 22:14:33,17,6,23,False,AAAAAAAAAAAAAAAAAAAHHHHHHHHHHHHHHHH,35
3003,885258771525767169,2017-07-12 22:05:13,0,0,0,True,@prentitss AAAAAAAAAAAAAAAAAAHHHHHHHH,37
3004,885258606563790849,2017-07-12 22:04:33,6,2,8,False,AAAAAAAAAHHHHH,14
3005,885256089842921472,2017-07-12 21:54:33,17,15,32,False,AAAAAAAAAAAAAAAAAAAAHHH,23
3006,885253571561836544,2017-07-12 21:44:33,7,1,8,False,AAAAAAH,7
3007,885251058355900416,2017-07-12 21:34:34,14,7,21,False,AAAAAAAAAAAAAHHHHHHHHHHHHHHHH,29
3008,885248539948982272,2017-07-12 21:24:33,10,5,15,False,AAAAAAAAAAHHHHH,15
3009,885246022825517056,2017-07-12 21:14:33,15,3,18,False,AAAAAAAAAHHHHHHHH,17
3010,885243508314996759,2017-07-12 21:04:34,8,1,9,False,AAAAAAAAAAAAAAAAAAAAAAHHHHHHH,29
3011,885240991598485504,2017-07-12 20:54:34,11,5,16,False,AAAAAAAAAAAAAAAAAAHHHHHHHHHHHHHHH,33
3012,885238472860196865,2017-07-12 20:44:33,9,2,11,False,AAAAAAAAAAAAHHHHHHH,19
3013,885235958014246912,2017-07-12 20:34:33,11,6,17,False,AAAAAAAAAAAAAAAAAAAAAH,22
3014,885233439330512899,2017-07-12 20:24:33,4,2,6,False,"AHHHHH 
https://t.co/FjuL4htOHg",31
3015,885230925692497920,2017-07-12 20:14:34,5,1,6,False,AAAAHHHHHHHHHHHHHHHH,20
3016,885229835190235140,2017-07-12 20:10:14,0,0,0,True,@harryharrold AAAAHHHHHHHHHH,28
3017,885228408149598208,2017-07-12 20:04:33,7,3,10,False,AAAAAAAHHHHHHHHHH,17
3018,885225891428696068,2017-07-12 19:54:33,13,3,16,False,AAAAAAAAAAAAAAAAAAAAHHHHHHHHHH,30
3019,885223373323849728,2017-07-12 19:44:33,3,0,3,False,AAAAAAHH,8
3020,885220856628039680,2017-07-12 19:34:33,10,3,13,False,AAAAAAAAAAAAAAAAHHHHHHHHHHHH,28
3021,885218340981137411,2017-07-12 19:24:33,2,1,3,False,AAAAAHHHHHHHHH,14
3022,885215825145323521,2017-07-12 19:14:33,18,10,28,False,AAAAAAAAAAAAAAAAAHHHHHHHHHHHHHHHH,33
3023,885213312186798080,2017-07-12 19:04:34,9,2,11,False,AAAAAAAAHHHH,12
3024,885210791183618049,2017-07-12 18:54:33,17,5,22,False,AAAAHHHHH,9
3025,885208273741369344,2017-07-12 18:44:33,4,1,5,False,AAAHHHHHHHHHHHHHHH,18
3026,885205758702477312,2017-07-12 18:34:33,18,4,22,False,AAAAAAAAAAAAAAAAAAAAAAAHHHHHH,29
3027,885203240228454400,2017-07-12 18:24:33,11,3,14,False,AAAAAAAAAAAHHHHHHHHH,20
3028,885200722501001216,2017-07-12 18:14:33,9,1,10,False,AAAAAAAAHHHHHHHH,16
3029,885198378103173121,2017-07-12 18:05:14,0,0,0,True,@joansull AAAAAAAAAAAAAAAAAHHH,30
3030,885198208149991432,2017-07-12 18:04:33,15,4,19,False,AAAAAAAAHHHHHHHHHHHHHHH,23
3031,885195691911524352,2017-07-12 17:54:33,8,2,10,False,AAAAAAHHHHHHHHHHHHHHHH,22
3032,885193174423044097,2017-07-12 17:44:33,8,1,9,False,AAAAAHHHHHHHHHH,15
3033,885192081936928769,2017-07-12 17:40:13,0,0,0,True,@a_marshall_plan AAAAAAAAAAAAAAHHHHHHHH,39
3034,885190659774320641,2017-07-12 17:34:33,9,3,12,False,AAHHHHHHHH,10
3035,885188140046180352,2017-07-12 17:24:33,18,14,32,False,AAAAAAAAAAAAAAAAAAAAHHHHHHHHHHH,31
3036,885185622721409025,2017-07-12 17:14:33,10,2,12,False,AAAAAAAAAAAAAAAAAAAHHH,22
3037,885183110228344833,2017-07-12 17:04:34,8,0,8,False,AAAAAAAAAAAAAAAHHHH,19
3038,885180592563920897,2017-07-12 16:54:33,9,0,9,False,AAAHHHHHHHHH,12
3039,885178074664448000,2017-07-12 16:44:33,8,1,9,False,AAAAHHHHHHH,11
3040,885175560124727296,2017-07-12 16:34:33,5,1,6,False,AAAAAAAAAAAAAAAAAAAAHHH,23
3041,885173040388210688,2017-07-12 16:24:33,6,0,6,False,"AAAAAAAAAHHHH 
https://t.co/GjpsuOA9j0",38
3042,885170526016217088,2017-07-12 16:14:33,6,1,7,False,AAAAAAAAAAAAAAAAAAAAAAHHHHHHHHHHHH,34
3043,885168007802212352,2017-07-12 16:04:33,4,0,4,False,AAAAAAAAAHH,11
3044,885165494784983040,2017-07-12 15:54:34,6,0,6,False,AAAAHH,6
3045,885162977158201345,2017-07-12 15:44:33,13,2,15,False,AAAAAAAAAAAAAAAAAAHH,20
3046,885160461003616257,2017-07-12 15:34:34,16,8,24,False,AAAAAAAAAAAAAAAAHHHHHHHHHHHHHH,30
3047,885157943318126592,2017-07-12 15:24:33,10,6,16,False,AAAAAAAAAAAAAAAAAAAHHHHHHHHHHHHH,32
3048,885155426391777280,2017-07-12 15:14:33,5,3,8,False,AAAAAAAAAHHHHHHHHHH,19
3049,885152908257497088,2017-07-12 15:04:33,8,4,12,False,AAHHH,5
3050,885150551083802624,2017-07-12 14:55:11,0,0,0,True,@cflores178250 AAAAAAAAAAAAAAAHHHHHHHHHH,40
3051,885150392727764992,2017-07-12 14:54:33,3,2,5,False,AAAAAAAAAAAAAAHHH,17
3052,885149297725059072,2017-07-12 14:50:12,2,0,2,True,@TheRoadbeer AAAAAHHHHHHHH,26
3053,885147875226910720,2017-07-12 14:44:33,9,7,16,False,AAAAAAHHH,9
3054,885145359915388928,2017-07-12 14:34:33,5,2,7,False,"AAAAAAAAAHHHHHHHHHHHHH 
https://t.co/aofN6lUDJJ",47
3055,885142843739836416,2017-07-12 14:24:33,11,3,14,False,AAAAAAAAAAAAAAAAAAAAAHHHHH,26
3056,885140323437088768,2017-07-12 14:14:32,10,4,14,False,AAAAAAAHHHHHHHHHHHHHHHH,23
3057,885139231999447042,2017-07-12 14:10:12,0,0,0,True,@mikes_booh AAAAAAAAAAAAAAAAAAHHHHHHHHHH,40
3058,885137810273054722,2017-07-12 14:04:33,11,4,15,False,AAAAAAAAAAAAAAAAAAAAAHHHHHHHHHH,31
3059,885135291857731584,2017-07-12 13:54:33,6,0,6,False,AAAAAAAAAAAAAAAAAAAAH,21
3060,885134198335578113,2017-07-12 13:50:12,0,0,0,True,@TrexPushups AAAAAAAAAAHHHHHH,29
3061,885132777145946112,2017-07-12 13:44:33,7,1,8,False,AAAAAAAAAAAAAAAHHHHHHH,22
3062,885130260634906624,2017-07-12 13:34:33,9,5,14,False,AAAAAAAAAAAAAAAAAHHHHH,22
3063,885127744018948099,2017-07-12 13:24:33,8,1,9,False,AAAAAAAAAAAAAAAAAAAHHH,22
3064,885125226400493568,2017-07-12 13:14:33,17,5,22,False,AAAAAAAAAAAAAAAAHHHHHHHHHHHHHHHH,32
3065,885122714087936004,2017-07-12 13:04:34,8,5,13,False,AAAAAAAAAAAAAAAAAAAHHHHHHH,26
3066,885120191709020161,2017-07-12 12:54:33,10,4,14,False,AAAAAAAAAAAAAAAAAAAAAHHHH,25
3067,885117677643104256,2017-07-12 12:44:33,6,0,6,False,AAAAAAAAAAAAAAAHH,17
3068,885115158615515136,2017-07-12 12:34:33,3,0,3,False,AAAAAAAAHHHHHHHH,16
3069,885112641479483395,2017-07-12 12:24:32,3,1,4,False,AAAAAHHHHHH,11
3070,885110126440570881,2017-07-12 12:14:33,10,2,12,False,AAAAAAAAAAAAH,13
3071,885107771133317120,2017-07-12 12:05:11,0,0,0,True,@_MiMiOh AAAAAAAAAAAAAAAAAAAAHHHHHHHHH,38
3072,885107612173336576,2017-07-12 12:04:33,3,0,3,False,AHHHHHHHHHHHHHH,15
3073,885105094240456705,2017-07-12 11:54:33,19,4,23,False,AAAAAAAAAAAAAAAAHHHH,20
3074,885102578736013312,2017-07-12 11:44:33,5,3,8,False,"AAAAAAAAAAAAAAAAAAAAAAHHHHHHHHHH 
https://t.co/FjuL4htOHg",57
3075,885100062329667584,2017-07-12 11:34:33,4,0,4,False,AAAAAAAAHHHHHHHHHHHH,20
3076,885097545264975872,2017-07-12 11:24:33,10,0,10,False,AHHHHHH,7
3077,885095028896538625,2017-07-12 11:14:33,6,0,6,False,AAAAAAAAAAAAAAAAAHHHHHH,23
3078,885092509663318017,2017-07-12 11:04:33,6,1,7,False,AAAAHHHHHHHHHHHHH,17
3079,885089993651257344,2017-07-12 10:54:33,11,2,13,False,AAAAAAAAHHHHHHHHH,17
3080,885088896895381504,2017-07-12 10:50:11,1,1,2,True,@Plumenvahseh AAAAAAAAHHH,25
3081,885087642790105091,2017-07-12 10:45:12,1,1,2,True,@Plumenvahseh AAAAHHHHHHHHHH,28
3082,885087480017506305,2017-07-12 10:44:34,15,2,17,False,AAAAAAAAAAAHHHHHHHHHHHHHHHH,27
3083,885084960541036544,2017-07-12 10:34:33,10,1,11,False,AAAAAAAAAAAAAAAAAAAAAAAHHHHHHH,30
3084,885082445946769408,2017-07-12 10:24:33,8,1,9,False,AAAAAAAHHHHHHHHHHHHHHH,22
3085,885079927682469890,2017-07-12 10:14:33,11,3,14,False,AAAAAAAAAAAAAAAHHHHHHHH,23
3086,885077411318181888,2017-07-12 10:04:33,7,3,10,False,AAAAAAAAAAAAAAAAAAHHHHHHHHHHHHHH,32
3087,885074894249230336,2017-07-12 09:54:33,7,2,9,False,AAAAAAAAAHHHHHH,15
3088,885072376832163841,2017-07-12 09:44:33,6,1,7,False,AAAHH,5
3089,885069862657302528,2017-07-12 09:34:33,14,2,16,False,AAAAAAAAAAAAAAAAAHHHH,21
3090,885067347098206208,2017-07-12 09:24:33,5,1,6,False,AHHH,4
3091,885064830801018882,2017-07-12 09:14:34,6,1,7,False,AAAAAHHHHHHH,12
3092,885062311974772736,2017-07-12 09:04:33,16,4,20,False,AAAAAAAAAAAAAAAAAAAAAAAHHHHHHHH,31
3093,885059796411588609,2017-07-12 08:54:33,6,2,8,False,AAAAAAAHHHHHHHHHHHHHH,21
3094,885057281511108608,2017-07-12 08:44:34,8,2,10,False,AAAAAAAAAAAAAAHHHHHHHHHHHHHH,28
3095,885054762571444224,2017-07-12 08:34:33,12,5,17,False,AAAAAAAAAAAAAAAAAAAAAHHHHHH,27
3096,885052247222226944,2017-07-12 08:24:33,2,1,3,False,AAAAAAAAAAAAHHHHHHHHHHHHHHHH,28
3097,885049728131575810,2017-07-12 08:14:33,3,2,5,False,AAAAAAAAAAAAAAAAAAAHHHHHHHHH,28
3098,885047211356246017,2017-07-12 08:04:33,7,0,7,False,AAAHHH,6
3099,885044696808132608,2017-07-12 07:54:33,3,1,4,False,AAAAAAAAAAAAAAAAHHHHH,21
3100,885042181127450625,2017-07-12 07:44:33,9,5,14,False,AAAAAAAAAAAAAAAAAAAAAAAHHHHHHHHHHHHH,36
3101,885039663102259200,2017-07-12 07:34:33,20,9,29,False,AAHHHHHHHHHHHHH,15
3102,885037144997285889,2017-07-12 07:24:33,1,4,5,False,AAAAAAAAAHHHHHHHHH,18
3103,885034789862027266,2017-07-12 07:15:11,0,0,0,True,@chuckyoutwo AAAAHHHHHHHHHHHHHHH,32
3104,885034789769818112,2017-07-12 07:15:11,0,0,0,True,@chuckyoutwo AAAAHHH,20
3105,885034789765623808,2017-07-12 07:15:11,0,0,0,True,@chuckyoutwo AHHHH,18
3106,885034789748830208,2017-07-12 07:15:11,0,0,0,True,@chuckyoutwo AHHHHH,19
3107,885034629635469312,2017-07-12 07:14:33,9,5,14,False,"AAAAAAAAAAAAAAAHHHHHHHHHHHHHHH 
https://t.co/yV4Viu5hXX",55
3108,885032114919440387,2017-07-12 07:04:33,2,2,4,False,AAAAAAHH,8
3109,885029594327384066,2017-07-12 06:54:32,8,3,11,False,AAAAAAAAAAAAHH,14
3110,885027078420275200,2017-07-12 06:44:33,14,9,23,False,AAAAAAAAAAAAAAAAAH,18
3111,885024560806055938,2017-07-12 06:34:32,11,1,12,False,AAAAAAHHHHH,11
3112,885022048900272129,2017-07-12 06:24:34,7,4,11,False,AAAAAAAAAAAAAAHH,16
3113,885019528102645760,2017-07-12 06:14:33,11,3,14,False,AAHHHHH,7
3114,885017014720483332,2017-07-12 06:04:33,13,1,14,False,AAAAAAAAAHHHHHHHHHHH,20
3115,885014497248894979,2017-07-12 05:54:33,8,3,11,False,AAAAAAAAAAAAAHHHHHHHHHHH,24
3116,885011980926550016,2017-07-12 05:44:33,3,0,3,False,AAAAAAAHHHHHHHHH,16
3117,885009461890482182,2017-07-12 05:34:33,23,5,28,False,AAAAAAAAAAAAAAAAAAAAAAAHHHHHHHHHHHHHHH,38
3118,885006946952196096,2017-07-12 05:24:33,6,3,9,False,AAAAHHHHHHHHHHHH,16
3119,885004430638288896,2017-07-12 05:14:33,7,3,10,False,AAAAAAAAH,9
3120,885001914647281667,2017-07-12 05:04:33,10,6,16,False,AAAHHHHHHHH,11
3121,884999395590246403,2017-07-12 04:54:33,9,3,12,False,AAAHHHHHHHHHHH,14
3122,884996879804772352,2017-07-12 04:44:33,14,3,17,False,AAAAAAAAAAAAAAAAAAH,19
3123,884994365713723395,2017-07-12 04:34:33,14,5,19,False,AAAAAAAAAAAAAAAAAAHHHHHHHHHHHH,30
3124,884991847071920129,2017-07-12 04:24:33,13,0,13,False,AHH,3
3125,884989333467430912,2017-07-12 04:14:34,10,7,17,False,AAAAAAAAAHHHHHHHH,17
3126,884988236904398849,2017-07-12 04:10:12,0,0,0,True,@mo_rf_i AAAAAAAAAAAAAAAHHHHHHH,31
3127,884986814527922176,2017-07-12 04:04:33,9,3,12,False,AAAAHHHH,8
3128,884984297677094914,2017-07-12 03:54:33,8,2,10,False,AAAAAHHHHHHHHHHH,16
3129,884981782394941445,2017-07-12 03:44:33,7,2,9,False,AAAAAAAAAAAAAHHHHHHH,20
3130,884979265514737665,2017-07-12 03:34:33,19,8,27,False,AAAAAAAAAAAHHHHHHHHHHHH,23
3131,884976747380436997,2017-07-12 03:24:33,11,0,11,False,AAHHHHHHHHHHH,13
3132,884974233021014016,2017-07-12 03:14:33,12,2,14,False,AAAAAAAAAAAAAHHHHHHHHHHHHHHH,28
3133,884971715524272128,2017-07-12 03:04:33,7,1,8,False,AHHHHHHHHHHHH,13
3134,884970625684688896,2017-07-12 03:00:13,0,0,0,True,@darknote62 AAAAAAAAAAAAAAAAAHHHHHHHHHHH,40
3135,884969359705341952,2017-07-12 02:55:11,0,0,0,True,@darknote62 AAHHHH,18
3136,884969199747166209,2017-07-12 02:54:33,10,5,15,False,AAAAAAAAAAAHHHHHHHHHHHHHH,25
3137,884966680870432768,2017-07-12 02:44:33,11,4,15,False,AAAAAAAAHHHHHHHHHHHH,20
3138,884964165340868608,2017-07-12 02:34:33,13,6,19,False,AAAAAAAHHHHHH,13
3139,884961648188022784,2017-07-12 02:24:33,7,4,11,False,AAAAAAHHHHHHHHH,15
3140,884959131358113793,2017-07-12 02:14:33,9,2,11,False,AAAAAAAHHHHHHHHHHHH,19
3141,884956615534931968,2017-07-12 02:04:33,9,3,12,False,AAAAAAAAAAH,11
3142,884954099925606400,2017-07-12 01:54:33,14,5,19,False,AAAAAAAAAAAAAAAHHHHHHHHHHHHHH,29
3143,884951583347404800,2017-07-12 01:44:33,17,6,23,False,AAAAAAAAAAAAAAAAAAAAHHHHHHHHHHH,31
3144,884949066978930688,2017-07-12 01:34:33,17,4,21,False,AAAAAAAAAAAAAAAAAAAAAAHHH,25
3145,884946550882959360,2017-07-12 01:24:33,6,6,12,False,AAAAAAAAAAAHHHHHHHH,19
3146,884944033855963136,2017-07-12 01:14:33,7,1,8,False,AAAAAHHHHHHHHHHHHHH,19
3147,884941518133506048,2017-07-12 01:04:33,12,2,14,False,AAAAAAAAAAHHHHHHHH,18
3148,884938999097380865,2017-07-12 00:54:33,6,1,7,False,AAHHHHHHHHHHHHHH,16
3149,884936484490555392,2017-07-12 00:44:33,16,7,23,False,AAAAAAAAAAAAAAAAAHHHHHHHHHHHHHHH,32
3150,884933965961887746,2017-07-12 00:34:33,6,3,9,False,AAAAAAAAAAAAAHHHHHHHH,21
3151,884932875023507456,2017-07-12 00:30:13,0,0,0,True,@artist_tao AAAAAAAAAAAAAAAAAAAAHHHHHHH,39
3152,884931449438261248,2017-07-12 00:24:33,10,1,11,False,AAAAAAAAAAAAAAAAAAHHH,21
3153,884929089999654913,2017-07-12 00:15:10,0,0,0,True,@MrWarlokh AAAAAAHHHHHHHHHHHH,29
3154,884928931455008773,2017-07-12 00:14:33,11,3,14,False,AAAAAAAAAAAAAAAAAAAAAAAHHHHHHHHH,32
3155,884926417083002880,2017-07-12 00:04:33,11,3,14,False,AHH,3
3156,884923900731248640,2017-07-11 23:54:33,10,5,15,False,"AAAAAAAAHHHHHHHHHHHHHH 
https://t.co/aofN6lUDJJ",47
3157,884921382747983872,2017-07-11 23:44:33,13,5,18,False,AAAAAAAHHHHH,12
3158,884918868254351362,2017-07-11 23:34:33,13,6,19,False,AAHHHHHHH,9
3159,884916351197790209,2017-07-11 23:24:33,16,10,26,False,AAAAAAAAAAAAAAAAHHHHHHHHHHHHHHH,31
3160,884913834397487105,2017-07-11 23:14:33,13,8,21,False,AAAAAAAAAAAAAAAAAAAAAHHHHHHHHHHH,32
3161,884911317068468224,2017-07-11 23:04:33,12,7,19,False,AAAAAAAAAAAAHHHHHHHH,20
3162,884908799114522624,2017-07-11 22:54:33,10,6,16,False,AAAAAAAAAAAHHHHHHH,18
3163,884907703574900738,2017-07-11 22:50:11,1,0,1,True,@KatiSipp AAAAAAAAAAAAH,23
3164,884906281198342144,2017-07-11 22:44:32,14,4,18,False,AAAAAAAAAAAAAAAAAAAHHHHHH,25
3165,884903941951172609,2017-07-11 22:35:15,0,0,0,True,@davidb813 AAHHHHHHHHHHHH,25
3166,884903768399257600,2017-07-11 22:34:33,13,3,16,False,AAAAAAAAAAAAAAAAAAAHHHHHHH,26
3167,884901248117481472,2017-07-11 22:24:32,8,4,12,False,AAAAAAAAAHHHHHHH,16
3168,884898733569302528,2017-07-11 22:14:33,11,4,15,False,AAAAAAAAAAAAAAAAAAAAAAHHHHHHHHH,31
3169,884896218974998529,2017-07-11 22:04:33,21,4,25,False,AAAAAAAAAAAAAHHHHHHHHHHHHHH,27
3170,884893867354533888,2017-07-11 21:55:13,0,0,0,True,@Dulana57 AAAAAHHHHHHHHHHHHHHHH,31
3171,884893701805408259,2017-07-11 21:54:33,6,0,6,False,AAAAAAAAAAAAAAAH,16
3172,884891184283496452,2017-07-11 21:44:33,8,3,11,False,AAAAAAAAAAAAAAAAAAAAAAAHHH,26
3173,884888668711915521,2017-07-11 21:34:33,10,3,13,False,AAAAAAAAAAAAAAAAAAAAHHHHHHHHHHHHHHH,35
3174,884886150724427776,2017-07-11 21:24:33,10,3,13,False,AAAAAAAAAAAAAAAAAHHHH,21
3175,884883635370852352,2017-07-11 21:14:33,12,7,19,False,AAAAAAAAAAAAHHHHHHHHHH,22
3176,884881301018472449,2017-07-11 21:05:17,1,0,1,True,@jamespugjones AHHHHHHHHHHHHHHHH,32
3177,884881117479936001,2017-07-11 21:04:33,7,1,8,False,AAAAAAHHHHHHHH,14
3178,884880026843439104,2017-07-11 21:00:13,0,0,0,True,@sorrykb AAAAAAAAAAAAAAAAAAHHHHH,32
3179,884878601908346880,2017-07-11 20:54:33,5,0,5,False,AAAAAHHHHHHHHHH,15
3180,884876082649989120,2017-07-11 20:44:32,11,1,12,False,AAAAAAAAAHHHHHHHHHHHHHHHH,25
3181,884874989773705216,2017-07-11 20:40:12,0,0,0,True,@Joom35Ryeland AAAAAAAAAAAAHHHHH,32
3182,884873741200764929,2017-07-11 20:35:14,1,0,1,True,@Joom35Ryeland AAAAAAAAAAAAAAAHHHHHHHHHHHHHHH,45
3183,884873568642838529,2017-07-11 20:34:33,14,5,19,False,AAAAAAAAAAAAAAAAAAAAAHHHHHHHHHH,31
3184,884871221606838272,2017-07-11 20:25:14,0,0,0,True,@TheDamBeaver AAAAAAAAAAAAAAAAAHHHHHHHHHHHHHHHH,47
3185,884871050248560641,2017-07-11 20:24:33,21,11,32,False,AAAAAAAAAAAAAAAAAHHHHHHHHHHHHHHHH,33
3186,884868536455352322,2017-07-11 20:14:33,8,3,11,False,AAAAAAAAAAAAAAAAAHH,19
3187,884867444774449154,2017-07-11 20:10:13,0,0,0,True,@lnpRscum AAAAAAAAAAAAAAAAAAAHHHHHHHHHHHH,41
3188,884866192665702402,2017-07-11 20:05:15,0,0,0,True,@GamingChode AAAAAAAAAAAHHHHHHHHHHHHHHH,39
3189,884866019935891458,2017-07-11 20:04:33,13,7,20,False,AAAAAAAAAHHHHHHHH,17
3190,884863501432496128,2017-07-11 19:54:33,7,3,10,False,AAAAAHHHH,9
3191,884860984476807169,2017-07-11 19:44:33,6,2,8,False,AAAAAAAAAAAAHHHH,16
3192,884858470226440195,2017-07-11 19:34:33,13,3,16,False,AAHHHHHHHHHHHHHHH,17
3193,884855952243134464,2017-07-11 19:24:33,12,3,15,False,AAAAAHHHHHHHHHHHHHHHH,21
3194,884853437728522241,2017-07-11 19:14:33,5,0,5,False,AAAHHHHHHHHHH,13
3195,884850927324286978,2017-07-11 19:04:35,16,4,20,False,AAAAAAAAAAAAAAAHHHHHHHHHHH,26
3196,884849868782612480,2017-07-11 19:00:23,1,2,3,True,@humantorch AAAAAAAAAAAAAAAAAHHHHHHHH,37
3197,884848400600100864,2017-07-11 18:54:33,15,7,22,False,AAAAAAAHHHHHHHHHHHHHH,21
3198,884845887276691456,2017-07-11 18:44:33,7,5,12,False,AAAAAAAAAAAAAAAAAAHH,20
3199,884844792483598337,2017-07-11 18:40:12,0,0,0,True,@towittertoo AAAAAAAAAAAAAHHHHHHHH,34
3200,884843370723594240,2017-07-11 18:34:33,11,8,19,False,AAAAAH,6
3201,884842283790721025,2017-07-11 18:30:14,0,0,0,True,@nisaba__ AAAAAHHHHHHHHHHHHH,28
3202,884840855114313731,2017-07-11 18:24:34,8,0,8,False,AAAAAAAHHHHHHHHHHHHH,20
3203,884839762015789058,2017-07-11 18:20:13,0,0,0,True,@MarkU400vip AAAAAAAAAAAAHH,27
3204,884838338020114432,2017-07-11 18:14:33,9,3,12,False,AAAAAAAAAHHHHHHHHHH,19
3205,884835817449025536,2017-07-11 18:04:32,10,5,15,False,AAAAAAAAAAAHHHHHHHHHHHHHH,25
3206,884833301973913601,2017-07-11 17:54:33,11,3,14,False,AAAAAAAAAAAAAHHHHHHHHHHH,24
3207,884830787115331585,2017-07-11 17:44:33,9,10,19,False,AAAAAAAAAHHHHHHHHHHH,20
3208,884828268343554050,2017-07-11 17:34:33,10,5,15,False,AAAAAAAAAAAAAAAAAAAAAAAHHHHHHHH,31
3209,884825753417920521,2017-07-11 17:24:33,10,5,15,False,AAAAAAAAAAAAAAAAAHHHHHH,23
3210,884823415756120066,2017-07-11 17:15:16,0,0,0,True,@AnaArqis AAAAAAAAHHHHHHHHHHHHHHH,33
3211,884823234973184000,2017-07-11 17:14:33,10,3,13,False,AAAAAHHHHHHH,12
3212,884822139462877184,2017-07-11 17:10:11,2,0,2,True,@toxchick42 AH,14
3213,884820720143958017,2017-07-11 17:04:33,18,10,28,False,AAAAAAAAAAAAAAAAAAHHHHHHHHHHHHH,31
3214,884818201355460610,2017-07-11 16:54:32,9,1,10,False,AAAAAAHHHHHHHHHHHH,18
3215,884815684424880128,2017-07-11 16:44:32,5,2,7,False,AAAAAAAAAAAHHHHHH,17
3216,884813338823340032,2017-07-11 16:35:13,0,0,0,True,@dbennett_ks AAAAAAAHHHHHHHHH,29
3217,884813169050480642,2017-07-11 16:34:33,10,6,16,False,AAAAAAAAAAAAAAAAAAAAAHHHHHH,27
3218,884810653881466881,2017-07-11 16:24:33,8,4,12,False,AAAAHHHHHHHHHHHH,16
3219,884808137995423745,2017-07-11 16:14:33,4,4,8,False,AAAHHH,6
3220,884807046155161600,2017-07-11 16:10:13,0,0,0,True,@ThisBarbara AAAAAHHHHHH,24
3221,884805619319963649,2017-07-11 16:04:33,9,4,13,False,AAH,3
3222,884803102053990401,2017-07-11 15:54:33,16,13,29,False,AAAAAAAAAAAAAHHHHHHHHHHHHH,26
3223,884800587384205312,2017-07-11 15:44:33,4,2,6,False,AAAAAAAAAAAAAAAAH,17
3224,884798071237947392,2017-07-11 15:34:33,7,4,11,False,AAAAAAAAAAAAAAAAAAAAAHHHH,25
3225,884795721978957824,2017-07-11 15:25:13,0,0,0,True,@kimberlite AAAHHHHHHHHHH,25
3226,884795555414773760,2017-07-11 15:24:33,14,5,19,False,AAAAAAAAAAAAHHHHHH,18
3227,884793201126772737,2017-07-11 15:15:12,0,0,0,True,@WickedEls AAAAAAHHHHHHHHHHHHHHHH,33
3228,884793038891081728,2017-07-11 15:14:33,35,17,52,False,AAAAAAAAAAAAAAAAAAAAAHHHHHHHH,29
3229,884790689510424577,2017-07-11 15:05:13,1,0,1,True,@color_mage AAAAAAAAHHHH,24
3230,884790521276792832,2017-07-11 15:04:33,5,8,13,False,AAAAAAAAAAAAHHHHHHHHH,21
3231,884788006892314624,2017-07-11 14:54:34,10,6,16,False,AAAAAAAAAAAAAAAAAAAHHHHHHHHHHHHHHH,34
3232,884785491656278016,2017-07-11 14:44:34,9,0,9,False,AAAAAAAAHH,10
3233,884782982585868288,2017-07-11 14:34:36,12,6,18,False,AAAAAAAH,8
3234,884780464527036417,2017-07-11 14:24:35,13,7,20,False,AAAAAAAAAAHHHHHHHHHHH,21
3235,884777948074696704,2017-07-11 14:14:35,11,5,16,False,AAAAH,5
3236,884775431819456512,2017-07-11 14:04:35,17,11,28,False,AAAAAAAAAAAAAAAAHHHHHHHHHHHHHHH,31
3237,884772912863096833,2017-07-11 13:54:35,20,9,29,False,AAAAAAAAAAAAAAAAAAAAHHHHHHHHHHHH,32
3238,884770400177184768,2017-07-11 13:44:36,6,1,7,False,AAAAAAAAHHHH,12
3239,884767881078157314,2017-07-11 13:34:35,11,5,16,False,AAAAAAAAHHHHHH,14
3240,884765365590511616,2017-07-11 13:24:35,6,2,8,False,AAAAAAAAAAAAAHHHHHHHHHHHHHHHH,29
3241,884762849263984640,2017-07-11 13:14:36,6,6,12,False,AAAAAAAAAAHHHHHHHHH,19
3242,884760498243342337,2017-07-11 13:05:15,0,1,1,True,@Aiman_1_Gamer AAHHHHHHHHHH,27
3243,884760333230977025,2017-07-11 13:04:36,12,5,17,False,AAAAAAAAAHHHHHHHHHHHHH,22
3244,884757971766566913,2017-07-11 12:55:13,0,0,0,True,@Aiman_1_Gamer AAAAAHHHHHHHHH,29
3245,884757813330837507,2017-07-11 12:54:35,20,8,28,False,AAAAAAAAAAAAAAAAAAAAAAAHHHHHH,29
3246,884755290876518400,2017-07-11 12:44:33,24,8,32,False,AAAAAAAAAAAAAAAAAAAAHHHHHHHHHHHHHH,34
